工=a
匿=aad
葚=aadn
慝=aadn
萁=aadw
苷=aaff
芽=aah
茝=aahh
戒=aak
苣=aanf
苉=aaqb
荛=aatq
式=aay
节=ab
荫=abe
茸=abf
邛=abh
蒸=abi
菡=abib
荪=abiu
茁=abm
芤=abnb
艿=abr
菰=abry
萨=abu
匜=abv
芨=abyu
芭=ac
茎=aca
苔=ack
茅=acn
蓣=acnm
其=ad
苊=adbb
蕻=adcw
戎=ade
葫=adef
苈=ader
苦=adf
蓐=adff
萘=adfi
葳=adgy
葴=adgy
荐=adh
葜=adhd
茬=adhf
苤=adhg
芣=adhu
藉=adi
藕=adiy
若=adk
鄀=adkb
惹=adkn
项=adm
蒇=admy
藏=adn
荙=adpu
䓫=adsk
蕨=aduw
基=adw
戡=adwa
期=adwe
勘=adwe
斟=adwf
綦=adwi
甚=adwn
惎=adwn
斯=adwr
蓁=adwt
欺=adww
茂=adx
茏=adxy
莽=ady
功=ae
菔=aebc
莩=aebf
荔=aee
蒯=aeej
苴=aegf
茄=aek
藐=aer
菜=aes
散=aety
藤=aeu
荽=aevf
苏=aew
萸=aewu
著=af
邯=afb
芸=afc
芰=afcu
甘=afd
薷=afdj
芏=aff
葑=afff
蒜=afi
薹=afkf
薳=afkp
蕾=afl
贰=afm
萳=afmf
苇=afn
荸=afpb
芜=afq
芫=afqb
莰=afqw
某=afs
蓍=aftj
荖=aftx
蔷=afu
芙=afw
爇=afwo
菱=afwt
藿=afwy
七=ag
荆=aga
匡=agd
莆=age
菁=agef
蕤=ageg
芋=agf
廿=agh
蔫=agho
蕙=agj
荁=agjg
=akg
蔌=agkw
芾=agmh
莿=agmj
颟=agmm
巧=agnn
戈=agny
莱=ago
葬=agq
薤=agqg
茉=ags
苹=agu
荚=agud
萋=agvv
荑=agxw
牙=ah
蘧=ahap
菲=ahd
匪=ahdd
芷=ahf
苜=ahf
菽=ahgc
䓬=ahjf
熙=ahk
苫=ahkf
颐=ahkm
赜=ahkm
卧=ahn
臣=ahnh
邪=ahtb
鸦=ahtg
迓=ahtp
雅=ahty
茈=ahxb
东=ai
茳=aiaf
蕖=aias
范=aib
菹=aieg
薄=aig
萍=aigf
蒲=aigy
菠=aih
莎=aiit
蕰=aijl
藻=aik
荡=ain
鸫=aiqg
蒎=aire
菏=ais
薸=aisi
落=ait
藩=aitl
汞=aiu
茫=aiy
蒗=aiye
划=aj
蕞=ajbc
莫=ajd
鄚=ajdb
募=ajde
墓=ajdf
蓦=ajdg
幕=ajdh
暮=ajdj
慕=ajdn
摹=ajdr
萌=aje
昔=ajf
草=ajfj
莳=ajfu
菖=ajj
蔓=ajl
葛=ajq
鹊=ajqg
蓝=ajt
茧=aju
郾=ajv
或=ak
葺=akbf
蕺=akby
叵=akd
革=akf
鞯=akfb
靶=akfc
鞁=akfc
鞅=akfd
勒=akfe
鞘=akfe
靿=akfe
鞋=akff
鞲=akff
靬=akff
靼=akfg
鞧=akfg
靽=akfg
鞴=akfh
鞮=akfh
鞒=akfj
鞳=akfk
鞨=akfn
鞠=akfo
鞑=akfp
鞬=akfp
靰=akfq
鞔=akfq
鞭=akfr
靳=akfr
鞣=akfs
靺=akfs
鞡=akfu
鞍=akfv
靴=akfx
鞫=akfy
靸=akfy
韂=akfy
勤=akg
鄞=akgb
堇=akgf
惑=akgn
觐=akgq
彧=akgy
蕗=akhk
匮=akhm
蒉=akhm
颧=akk
莒=akkf
鹳=akkg
萼=akkn
莴=akmw
燕=aku
苗=al
蔑=ald
蒽=aldn
茵=aldu
薯=alfj
匣=alk
茴=alkf
藟=alll
葸=alnu
莲=alp
瞢=alph
薨=alpx
甍=alpy
萝=alq
鹋=alqg
菌=alt
匦=alvv
黄=am
英=amd
蓇=amef
苒=amff
斠=amff
遘=amfp
觏=amfq
茼=amgk
匝=amh
萜=amhk
苘=amkf
苋=amqb
贡=amu
黇=amwk
芮=amwu
世=an
苠=anab
艺=anb
芑=anb
䓛=anbm
巨=and
蔚=anf
蔬=anh
葭=anhc
薜=ankf
勚=anme
贳=anmu
蕊=ann
苾=antr
芯=anu
荬=anud
蓼=anwe
忒=anyi
荩=anyu
苡=anyw
蔗=ao
蔊=aojf
藨=aono
菼=aoou
蘑=aos
蘼=aosd
藦=aosr
蒌=aovf
薮=aovt
劳=ap
菪=apdf
蒙=apf
蔻=apfc
茔=apff
蒄=apff
鹲=apfg
莞=apfq
莹=apg
苎=apgf
萱=apgg
萣=apgh
菅=aphn
荥=apiu
萤=apj
蓂=apjw
营=apk
荤=apl
茕=apnf
荧=apo
莺=apq
菀=apqb
蓥=apqf
䓨=aprm
荣=aps
苧=apsj
荦=aptg
芝=apu
蓉=apw
䓖=apwe
蓿=apwj
茓=apwu
葖=apwy
萦=apxi
获=aq
芪=aqab
茋=aqay
苑=aqb
萏=aqef
薢=aqeg
葡=aqg
茚=aqgb
藓=aqgg
蓟=aqgj
荀=aqj
敬=aqk
苟=aqkf
茗=aqkf
擎=aqkr
檠=aqks
警=aqky
菟=aqky
苞=aqn
菊=aqo
葱=aqr
萄=aqrm
芴=aqrr
茆=aqtb
荻=aqto
莸=aqty
匹=aqv
芡=aqwu
芍=aqy
茑=aqyg
区=ar
葩=arcb
萚=arcg
蓏=arcy
菝=ardy
瓯=arg
蒱=argy
茱=ariu
芹=arj
匠=ark
欧=arq
蒐=arqc
鸥=arqg
蔸=arqq
菂=arqy
藠=arrr
萆=artf
艾=aru
殴=arw
苛=as
茜=asf
蔈=asfi
苯=asg
蘸=asgo
葙=ashf
蕈=asjf
菥=asrj
菘=aswc
攻=at
苌=ata
莠=atb
医=atd
繄=atdi
荞=atdj
翳=atdn
蓬=atdp
芊=atfj
芼=atfn
莛=atfp
董=atg
翘=atgn
薰=atgo
尧=atgq
荇=atgs
蓰=athh
莉=atj
蓖=atl
薇=atm
薁=atmd
蕃=ato
萩=atou
藜=atqi
蘅=atqs
莪=atry
萎=atv
葎=atvg
蘩=atxi
莓=atxu
蒋=au
荓=auaj
蒴=aube
莘=aufj
薏=aujn
菩=auk
蔀=aukb
蕲=aulr
蔽=aum
茨=auq
蒟=auqk
薪=aus
蒺=autd
蒹=auvo
蔺=auw
切=av
艽=avb
菇=avd
薅=avdf
茛=aveu
荨=avfu
萧=avi
菉=aviu
茹=avk
苕=avkf
莙=avtk
芄=avyu
共=aw
苍=awb
䢼=awbh
蓊=awcn
葰=awct
芟=awcu
茯=awd
蔡=awf
荟=awfc
茌=awff
苻=awfu
葵=awg
蒨=awge
荃=awgf
莶=awgg
匼=awgk
荼=awgs
蔹=awgt
莜=awht
芥=awj
茽=awkh
葆=awks
恭=awn
巷=awnb
孽=awnb
薛=awnf
糵=awno
蘖=awns
茶=aws
荷=awsk
荏=awtf
莅=awuf
蓓=awuk
芬=awv
棻=awvs
巫=aww
莝=awwf
鹀=awwg
觋=awwq
苁=awwu
花=awx
恐=awy
苓=awyc
萑=awyf
蛩=awyj
劐=awyj
芩=awyn
菍=awyn
蕉=awyo
銎=awyq
芃=awyu
巩=awyy
药=ax
荭=axaf
芎=axb
荮=axfu
莼=axgn
蕴=axj
茀=axjj
蔃=axkj
薿=axth
芗=axtr
蒻=axuu
芘=axxb
荜=axxf
蒈=axxr
芳=ay
茺=aycq
苄=ayhu
弋=ayi
蔼=ayj
荠=ayjj
蓑=ayk
蘘=ayke
蒿=aykk
藁=ayks
葶=ayks
荒=ayn
匾=ayna
萹=ayna
芒=aynb
芦=aynr
荄=aynw
鸢=ayqg
蓠=ayrc
蔟=aytd
蒂=ayu
芠=ayu
蒡=ayuy
莨=ayve
蓢=ayve
萃=ayw
茭=aywr
蓄=ayx
蕹=ayxy
了=b
陈=ba
子=bb
陬=bbcy
孕=bbf
孖=bbg
耶=bbh
取=bc
陉=bcag
聂=bcc
颞=bccm
聚=bci
鄹=bcib
盈=bcl
戤=bcla
娶=bcv
随=bd
隋=bda
隳=bdan
堕=bdef
承=bdi
陌=bdj
陑=bdmj
陇=bdx
阴=be
阻=begg
际=bf
孺=bfd
陡=bfh
阱=bfjh
阮=bfq
陵=bfw
卫=bg
陆=bgb
耳=bgh
隔=bgk
陋=bgm
陕=bgu
耻=bh
陂=bhc
蚩=bhgj
陟=bhh
骘=bhhg
阽=bhkg
鼐=bhn
孙=bi
函=bib
丞=big
卺=bigb
烝=bigo
隙=bij
逊=bip
尕=biu
阳=bj
陧=bjfg
隅=bjm
隰=bjxo
职=bk
亟=bkc
聩=bkh
陨=bkm
阵=bl
勐=blet
孟=blf
隈=blge
出=bm
䢺=bmbh
祟=bmf
聃=bmfg
聘=bmg
粜=bmou
也=bn
孑=bnhg
孔=bnn
乃=bnt
耿=bo
院=bp
辽=bpk
耽=bpq
聍=bpsh
陀=bpx
隐=bq
陷=bqe
孢=bqn
陶=bqr
聊=bqt
孤=br
阪=brcy
隍=brgg
陎=briy
隗=brqc
陴=brtf
阿=bs
耵=bsh
降=bt
陞=btaf
聒=btd
陲=btf
阡=btfh
隆=btg
阼=bthf
隩=btmd
孜=bty
联=bu
隧=bue
障=buj
聪=buk
陪=bukg
隘=buw
限=bv
队=bw
附=bwf
坠=bwff
除=bwg
险=bwgg
隃=bwgj
阶=bwj
聆=bwyc
陛=bx
乸=bxi
及=by
孓=byi
孩=byn
陔=bynw
防=byt
以=c
戏=ca
颈=cad
劲=cae
弁=caj
刭=cajh
迳=cap
巯=cayk
邓=cb
又=cc
叕=cccc
垒=cccf
叠=cccg
剟=cccj
颡=cccm
桑=cccs
双=ccy
参=cd
叁=cdd
毵=cden
畚=cdl
能=ce
通=ceh
勇=cehe
甬=cehj
恿=cehn
劝=cet
熊=cexo
对=cf
圣=cff
怼=cfn
马=cg
驱=cga
骁=cgaq
骐=cgaw
骤=cgb
驰=cgbn
骚=cgc
骖=cgce
驿=cgcg
骉=cgcg
骀=cgck
骏=cgct
驭=cgcy
骑=cgdk
驮=cgdy
驵=cgeg
骦=cgfh
骊=cgg
驲=cgjg
骒=cgjs
驶=cgk
驯=cgkh
骡=cgl
骃=cgld
驷=cglg
骋=cgm
骣=cgnb
驼=cgp
驹=cgq
骝=cgql
驺=cgqv
驳=cgr
骠=cgsi
骄=cgt
骆=cgtk
骢=cgtn
骥=cgu
骈=cgua
骍=cguf
骎=cgvc
骕=cgvj
验=cgw
骙=cgwd
驸=cgwf
骅=cgwf
骓=cgwy
骗=cgy
骧=cgye
驻=cgyg
驴=cgyn
骟=cgyn
骇=cgyw
台=ck
邰=ckb
怠=ckn
炱=ckou
迨=ckp
枲=cksu
观=cm
岊=cmj
巴=cn
预=cnh
豫=cnhe
鹜=cnhg
骛=cnhg
鹬=cnhg
瞀=cnhh
予=cnhj
蟊=cnhj
蝥=cnhj
矞=cnhk
矜=cnhn
遹=cnhp
鍪=cnhq
柔=cnhs
矛=cnht
婺=cnhv
允=cq
欢=cqw
鸡=cqy
矣=ct
欸=ctdw
牟=ctg
艰=cv
难=cw
逡=cwt
皴=cwtc
叉=cy
蚤=cyj
在=d
左=da
厮=dad
磡=dade
矼=dag
砑=daht
礴=dai
厝=dajd
碏=dajg
砸=dam
碟=dan
礞=dap
奁=daru
砹=dary
硗=datq
砌=dav
硔=dawy
硭=dayn
顾=db
耷=dbf
础=dbm
厄=dbv
友=dc
硁=dcag
磉=dccs
碜=dcde
鬃=dce
鬈=dceb
髢=dceb
鬘=dcec
鬟=dcee
髯=dcef
髽=dcef
髫=dcek
髻=dcek
髦=dcen
鬣=dcen
鬏=dceo
髡=dceq
髹=dces
鬓=dcew
鬒=dcew
髭=dcex
码=dcg
翃=dcng
肆=dcv
雄=dcw
大=dd
套=ddc
磊=ddd
碱=ddg
砺=ddgq
厦=ddh
碶=ddhd
奭=ddjj
硕=ddm
厖=ddny
鿎=ddpy
䃎=ddqq
厌=ddy
魇=ddyc
靥=ddyd
餍=ddye
厣=ddyl
黡=ddyo
胡=de
郁=deb
历=dee
硼=deeg
有=def
砠=degg
鹕=deqg
夯=der
夺=df
奔=dfa
磕=dfc
砝=dfcy
辱=dfe
辰=dfei
蜃=dfej
唇=dfek
奎=dff
硅=dffg
矸=dfh
奈=dfi
礌=dflg
夸=dfn
刳=dfnj
匏=dfnn
砖=dfny
瓠=dfny
礵=dfsh
奢=dft
砆=dfwy
压=dfy
三=dg
研=dga
硎=dgaj
砘=dgbn
碃=dgeg
古=dgh
硬=dgj
感=dgk
厨=dgkf
觱=dgkh
咸=dgky
礓=dglg
碛=dgmy
厉=dgq
励=dgqe
厂=dgt
石=dgtg
砰=dgu
硖=dgud
威=dgv
戌=dgx
碡=dgxy
还=dh
戛=dhau
存=dhb
破=dhc
慧=dhd
砉=dhdf
奡=dhdj
彗=dhdv
甭=dhe
歪=dhg
邳=dhgb
丕=dhgf
蹙=dhgh
戚=dhgy
不=dhi
丰=dhk
否=dhkf
砧=dhkg
艳=dhq
夏=dht
契=dhv
孬=dhvb
䂮=dhvd
絜=dhvi
恝=dhvn
挈=dhvr
㛃=dhvv
耗=di
耢=diae
耩=diaf
耤=diaj
磲=dias
耔=dibg
耙=dic
耨=didf
耰=didt
硝=die
耕=dif
耘=difc
耜=dihn
耒=dii
耥=diik
耖=diit
耦=dijy
耱=diod
耧=diov
砂=dit
泵=diu
耠=diwk
耪=diy
百=dj
厚=djb
皕=djdj
厘=djfd
碍=djg
砷=djh
奄=djn
鹌=djng
碣=djqn
右=dk
夼=dkj
奋=dl
碨=dlge
砗=dlh
厍=dlk
面=dm
碘=dma
碳=dmd
碉=dmf
硐=dmgk
布=dmh
而=dmj
勔=dmje
耏=dmje
耐=dmjf
鸸=dmjg
厕=dmjk
恧=dmjn
耍=dmjv
硙=dmnn
砚=dmq
页=dmu
成=dn
碾=dna
臧=dnd
尨=dney
尪=dngd
嘏=dnhc
尴=dnj
尥=dnqy
砀=dnrt
尢=dnv
尬=dnw
砄=dnwy
盛=dnx
尤=dny
矿=do
盔=dol
磷=doq
灰=dou
达=dp
碹=dpgg
碇=dpgh
碗=dpq
牵=dpt
硿=dpwa
砣=dpxn
克=dq
砥=dqa
碈=dqaj
磔=dqas
兢=dqd
硊=dqdb
确=dqe
剋=dqjk
奓=dqqu
砍=dqw
鸪=dqyg
原=dr
斫=drh
愿=dri
爽=drr
碑=drt
厅=ds
硒=dsg
砵=dsgg
厢=dsh
碴=dsj
磹=dsjf
奇=dskf
剞=dskj
欹=dskw
故=dt
邦=dtb
帮=dtbh
硚=dtdj
寿=dtf
焘=dtfo
砟=dthf
硌=dtkg
硇=dtlr
砾=dtn
矻=dtnn
磻=dtol
砭=dtp
硪=dtry
磁=du
厥=dub
劂=dubj
辜=duf
砬=dug
磋=duga
鹩=dujg
碚=duk
䃅=dulh
碰=duo
磏=duvo
碌=dv
厩=dvc
硍=dvey
春=dw
砼=dwag
舂=dwe
磜=dwfi
奏=dwg
奉=dwgj
磴=dwgu
仄=dwi
泰=dwiu
蠢=dwjj
矶=dwn
砜=dwry
秦=dwt
雁=dww
赝=dwwm
碓=dwyg
礁=dwyo
矾=dwyy
龙=dx
砒=dxx
袭=dxy
聋=dxyb
砻=dxyd
䶮=dxyd
垄=dxyf
戊=dxyi
龚=dxyw
詟=dxyy
太=dy
硫=dyc
飙=dydr
砫=dyg
丈=dyi
犬=dyi
礅=dyk
态=dyn
碥=dyna
磅=dyu
碲=dyuh
碎=dyw
磙=dywe
戍=dyx
毁=ea
腻=eafy
肛=eag
胨=eaiy
舁=eaj
膜=eajd
貘=eajd
腊=eajg
朦=eap
䝙=eary
服=eb
郛=ebbh
孚=ebf
朏=ebmh
乳=ebn
肥=ec
胫=eca
胎=eck
须=ed
肱=edc
胈=edcy
胯=edf
胚=edh
貊=edjg
腌=edjn
腼=edmd
媭=edmv
腠=edwd
胧=edx
肽=edy
月=ee
脬=eebg
勰=eeen
舀=eef
脟=eefy
朋=eeg
鹏=eeq
肋=eet
胁=eew
腴=eewy
脚=ef
肢=efc
胠=efcy
臑=efdj
肚=efg
肝=efh
虢=efhw
䏡=efiy
肼=efjh
膨=efk
臌=efkc
腩=efmf
肟=efnn
䏝=efny
脖=efp
豺=eft
肤=efw
肘=efy
且=eg
肫=egbn
县=egc
悬=egcn
爰=egdc
助=ege
膊=egef
腈=egeg
脯=egey
豚=egey
脿=egey
貆=egjg
膈=egk
肺=egm
雎=egwy
胰=egx
用=eh
叟=ehc
腓=ehd
胩=ehgh
胪=ehn
膛=ei
胱=eig
盥=eil
胆=ej
刖=ejh
胂=ejhh
腽=ejlg
腥=ejt
加=ek
驾=ekc
肿=ekh
臊=ekk
腭=ekkn
贺=ekm
脶=ekmw
迦=ekp
架=eks
哿=eksk
袈=ekye
舅=el
胭=eld
舆=elg
腘=elgy
胛=elh
腮=eln
䐃=elty
爵=elv
觅=em
腆=ema
腨=emdj
胴=emgk
爨=emgo
璺=emgy
肭=emwy
力=en
腒=endg
脲=eniy
肠=enr
鼠=enu
鼷=enud
鼫=enud
鼱=enue
鼯=enuk
鼩=enuk
鼬=enum
鼹=enuv
鼢=enuv
甩=env
脏=eo
膦=eoqh
腑=eow
脒=eoy
边=ep
受=epc
爱=epd
脓=epey
腙=epfi
脘=epfq
腚=epg
腕=epq
舜=epqh
膑=eprw
胺=epv
腔=epw
胸=eq
胝=eqay
脆=eqd
朓=eqiy
朐=eqkg
胞=eqn
舄=eqou
肷=eqwy
豹=eqy
貌=er
胍=ercy
腯=erfh
腺=eri
遥=erm
鹞=ermg
繇=ermi
邈=erqp
脎=ersy
脾=ert
采=es
彩=ese
膘=esf
腰=esv
膝=esw
胜=et
胀=eta
胣=etbn
臜=etfm
臼=eth
胙=ethf
腹=etj
胳=etk
貉=etkg
貔=etl
豸=etyt
脱=eu
胼=euah
腾=eud
塍=eudf
䲢=eudg
滕=eudi
縢=eudi
螣=eudj
媵=eudv
朕=eudy
胖=eug
膳=eugk
臆=euj
䏲=euxt
妥=ev
腿=eve
腱=evgp
貂=evkg
办=ew
股=ewc
胗=ewet
脍=ewfc
肸=ewfh
脸=ewg
腧=ewgj
臾=ewi
肌=ewn
貅=ewsy
脞=ewwf
脂=ex
奚=exd
谿=exdk
膙=exkj
脑=ey
脐=eyj
膻=eyl
脉=eyn
胲=eynw
肪=eyt
膀=eyu
胶=eyw
肮=eywn
腋=eywy
臃=eyx
地=f
域=fa
堪=fad
墈=fade
霰=faet
坩=fafg
卉=faj
堰=fajv
霸=fak
墐=fakg
贲=famu
堞=fans
塔=faw
邗=fbh
圾=fby
去=fc
弆=fcaj
却=fcb
㙍=fccc
动=fce
叆=fcec
埇=fceh
劫=fcet
盍=fclf
翅=fcn
运=fcp
魂=fcr
埃=fct
支=fcu
云=fcu
叇=fcvp
城=fd
雳=fde
坜=fdet
震=fdf
堐=fdff
垮=fdfn
坏=fdh
坯=fdhg
埯=fdjn
需=fdm
堧=fdmd
颥=fdmm
顸=fdmy
垯=fdpy
塬=fdri
埼=fdsk
堾=fdwj
协=fe
垺=febg
堋=feeg
埒=fefy
坥=fegg
霾=fejf
霓=feq
土=ff
邽=ffbh
邿=ffbh
坛=ffc
圭=fff
垚=ffff
堼=ffff
封=fffy
填=ffh
埴=ffhg
卦=ffhy
款=ffi
墘=ffjn
恚=ffn
雩=ffnb
鄠=ffnb
圬=ffnn
堵=fft
寺=ffu
墙=ffuk
堎=ffwt
二=fg
坉=fgbn
垤=fgcf
博=fge
埔=fgey
圩=fgfh
干=fggh
十=fgh
士=fghg
墕=fgho
雨=fghy
寸=fghy
垣=fgjg
埂=fgjr
塥=fgkh
垭=fgog
坪=fgu
起=fh
墟=fha
趣=fhb
坡=fhc
霏=fhd
趄=fhe
直=fhf
矗=fhfh
赶=fhfk
址=fhg
趔=fhgj
越=fhgy
赴=fhh
埗=fhht
趟=fhi
坫=fhkg
盐=fhl
武=fhn
鹉=fhng
赳=fhnh
垆=fhnt
趯=fhny
趋=fhq
赵=fhr
趱=fhtm
走=fhu
趑=fhuw
超=fhv
真=fhw
趁=fhwe
颠=fhwm
示=fi
霄=fie
霪=fief
霈=fig
垙=figq
未=fii
埫=fimk
釐=fitf
漦=fiti
嫠=fitv
垱=fivg
墚=fivs
进=fj
朝=fjf
戟=fjfa
斡=fjff
埋=fjfg
韩=fjfh
垾=fjfh
乾=fjfn
翰=fjfn
埘=fjfy
坦=fjg
堤=fjgh
刊=fjh
坤=fjhh
亓=fjj
井=fjk
墁=fjlc
塌=fjn
埸=fjq
堨=fjqn
喜=fk
颉=fkd
袁=fke
劼=fket
吉=fkf
喆=fkfk
埕=fkgg
圳=fkh
露=fkhk
酃=fkkb
埚=fkmw
埙=fkmy
鼓=fku
彭=fkue
鼙=fkuf
瞽=fkuh
嘉=fkuk
嚭=fkuk
憙=fkun
熹=fkuo
甏=fkuy
哉=fkx
载=fl
戴=fla
堌=fldg
雷=flf
堽=flgh
塄=flyt
南=fm
垌=fmgk
坰=fmkg
垲=fmnn
献=fmu
坝=fmy
坍=fmyg
志=fn
霨=fnff
霞=fnh
韬=fnhe
韦=fnhk
韫=fnhl
违=fnhp
韧=fnhy
韨=fnhy
墀=fnig
霹=fnk
圯=fnn
圮=fnn
声=fnr
场=fnrt
卖=fnud
觌=fnuq
亏=fnv
块=fnw
磬=fnwd
馨=fnwj
罄=fnwm
坭=fnxn
专=fny
赤=fo
郝=fob
赧=fobc
垿=foch
赫=fof
赭=fofj
墣=fogw
赪=fohm
圹=fot
螫=fotj
赦=foty
塘=fov
墉=fovh
过=fp
勃=fpb
孛=fpbf
鹁=fpbg
垸=fpfq
壹=fpg
彀=fpgc
觳=fpgc
榖=fpgc
縠=fpgc
壸=fpgg
懿=fpgn
毂=fplc
疐=fplh
壶=fpo
垞=fpta
垵=fpvg
壳=fpw
埪=fpwa
悫=fpwn
索=fpx
坨=fpxn
无=fq
坻=fqay
元=fqb
顽=fqd
埆=fqeh
鼋=fqkn
堍=fqky
雹=fqn
坞=fqng
远=fqp
均=fqu
鋆=fquq
坎=fqw
垢=fr
坂=frcy
坬=frcy
圻=frh
埤=frtf
坼=fryy
霜=fs
堙=fsfg
圢=fsh
鹴=fshg
坷=fsk
霖=fss
㙘=fsvg
栽=fsx
才=ft
鿍=ftah
圫=ftan
教=ftb
孝=ftbf
雾=fter
霆=ftf
埵=ftfg
圲=ftfh
考=ftg
垍=fthg
鼒=fthn
埏=fthp
者=ftj
都=ftjb
翥=ftjn
煮=ftjo
垎=ftkg
垧=ftmk
圪=ftn
墦=ftol
耇=ftqk
老=ftx
耋=ftxf
耆=ftxj
耄=ftxn
霉=ftxu
增=fu
丧=fue
幸=fuf
垃=fug
垟=fugh
墡=fugk
境=fuj
培=fuk
啬=fulk
霎=fuv
雪=fv
垠=fve
垏=fvgh
埭=fviy
埽=fvph
夫=fw
塅=fwdc
替=fwf
辇=fwfl
逵=fwfp
规=fwm
鬶=fwmh
埠=fwn
堠=fwnd
垛=fws
坋=fwvt
赍=fww
零=fwy
坽=fwyc
霍=fwyf
堆=fwyg
埝=fwyn
截=fwyy
盏=fx
毐=fxdf
坳=fxet
戋=fxyi
刬=fxyj
裁=fy
堉=fyce
霅=fyf
霭=fyj
霁=fyjj
壤=fyk
壕=fyke
墩=fykt
垓=fynw
塆=fyox
雱=fyr
垴=fyrb
坊=fyt
雯=fyu
墒=fyuk
塝=fyuy
埌=fyve
坑=fyw
坟=fyy
一=g
开=ga
邢=gab
琪=gad
形=gae
玒=gag
琊=gahb
玡=gaht
弄=gaj
型=gajf
刑=gajh
瑾=gakg
瓘=gaky
瑛=gam
璜=gamw
璥=gaq
珙=gawy
击=gb
珥=gbg
顿=gbn
邨=gbnb
屯=gbnv
到=gc
至=gcf
郅=gcfb
致=gcft
臻=gcft
玛=gcg
天=gd
瑚=gde
珛=gdeg
环=gdh
玤=gdhh
蚕=gdj
吞=gdk
顼=gdm
忝=gdnu
珹=gdny
琦=gds
琫=gdwg
瑃=gdwj
瑧=gdwt
珑=gdx
表=ge
琈=gebg
珕=geee
青=gef
豮=gefm
瑗=geg
玥=geg
珇=gegg
燹=gego
甫=geh
逋=gehp
敷=geht
豕=gei
珈=gek
靓=gem
逐=gep
瑷=gepc
靛=geph
静=geq
䴖=geqg
瑶=ger
豨=gerh
于=gf
邘=gfbh
珐=gfc
瓀=gfdj
珪=gff
㻬=gffn
玕=gfh
瑱=gfhw
珷=gfhy
琎=gfjp
盂=gfl
玮=gfn
迂=gfp
玩=gfq
玞=gfwy
五=gg
琶=ggc
琢=gge
王=ggg
璱=gggt
球=ggi
珸=ggkg
瑓=ggli
瑟=ggn
玙=ggng
瑨=ggoj
璈=ggqt
玶=gguf
琴=ggw
琵=ggx
珏=ggy
下=gh
琥=gha
璩=ghae
玻=ghc
正=ghd
琲=ghdd
焉=ghg
鄢=ghgb
琡=ghgc
玷=ghk
丐=ghn
丏=ghnn
忑=ghnu
璨=ghqo
政=ght
玼=ghxn
求=gi
珖=gigq
琐=gim
珰=givg
救=giy
裘=giye
逑=giyp
理=gj
亘=gjg
瑅=gjgh
惠=gjh
瑁=gjhg
珅=gjhh
更=gjr
甦=gjrg
瑆=gjtg
琨=gjx
璟=gjy
事=gk
郚=gkbh
琄=gkeg
吾=gkf
珵=gkgg
囊=gkh
蠹=gkhj
璐=gkhk
橐=gkhs
整=gki
束=gkii
剌=gkij
赖=gkim
速=gkip
敕=gkit
卅=gkk
噩=gkkk
璪=gkks
副=gkl
逼=gklp
融=gkm
鹝=gkmg
鬲=gkmh
翮=gkmn
鬷=gkmt
带=gkp
吏=gkr
敔=gkty
豆=gku
豇=gkua
豌=gkub
豉=gkuc
剅=gkuj
逗=gkup
画=gl
柬=gli
琏=glp
现=gm
遭=gma
曹=gmaj
瑞=gmd
再=gmf
䴓=gmhg
刺=gmi
棘=gmii
枣=gmiu
僰=gmiw
珊=gmm
璎=gmmv
责=gmu
两=gmw
邴=gmwb
丙=gmwi
璀=gmwy
丽=gmy
郦=gmyb
鹂=gmyg
逦=gmyp
与=gn
珉=gna
琚=gnd
珝=gng
欤=gngw
瑕=gnh
瑂=gnhg
瓦=gnn
玘=gnn
玚=gnrt
珌=gntt
璆=gnwe
玦=gnwy
来=go
严=god
慭=godn
亚=gog
戬=goga
鄑=gogb
垩=gogf
晋=gogj
恶=gogn
璞=gogw
灭=goi
赉=gomu
琰=goo
璘=goqh
瑭=gov
琛=gp
琮=gpf
瑄=gpgg
琔=gpgh
琯=gphn
珲=gpl
琬=gpq
瑢=gpwk
万=gq
殣=gqag
殛=gqbg
殆=gqc
殍=gqeb
殂=gqeg
劢=gqet
残=gqf
殖=gqfh
殪=gqfu
歹=gqi
珧=gqiy
列=gqj
裂=gqje
珣=gqjg
䴕=gqjg
虺=gqji
烈=gqjo
虿=gqju
趸=gqkh
殒=gqkm
殃=gqm
迈=gqp
殡=gqpw
殉=gqq
殊=gqr
熬=gqt
聱=gqtb
珋=gqtb
歼=gqtf
鳌=gqtg
骜=gqtg
螯=gqtj
赘=gqtm
嶅=gqtm
遨=gqtp
鏊=gqtq
殇=gqtr
敖=gqty
獒=gqty
殚=gqu
兀=gqv
琤=gqvh
殓=gqw
殁=gqwc
殄=gqwe
餮=gqwe
死=gqx
玖=gqy
玓=gqyy
珠=gr
碧=grd
珀=grg
瑝=grgg
瑔=griy
瑰=grq
璬=gryt
末=gs
玎=gsh
亍=gsj
珂=gsk
琳=gss
麦=gt
琇=gtb
瓒=gtf
珽=gtfp
麸=gtfw
珩=gtg
珞=gtk
瑀=gtky
璁=gtl
珦=gtmk
璠=gtol
麹=gtqo
玫=gty
平=gu
夹=gud
郏=gudb
颊=gudm
璲=guep
瑳=guga
璋=guj
妻=gv
珢=gvey
珒=gvgh
郪=gvhb
琭=gviy
玿=gvkg
瑙=gvt
珺=gvtk
珍=gw
玳=gwa
玱=gwbn
瑖=gwdc
瑜=gwg
璒=gwgu
玠=gwjh
玑=gwn
玢=gwvt
玲=gwy
琟=gwyg
琀=gwyk
互=gx
瑑=gxge
纛=gxhi
素=gxi
毒=gxu
夷=gxw
玭=gxxn
玉=gy
琉=gyc
珫=gycq
斑=gyg
琼=gyk
瓖=gyke
璮=gylg
璃=gyr
班=gyt
璇=gyth
琅=gyv
玹=gyxy
玟=gyy
上=h
虑=ha
虐=haa
虏=hae
瞒=hag
眶=hagg
遽=hagp
甗=hagy
虞=hak
瞄=hal
虚=hao
觑=haoq
眍=hary
虎=haw
彪=hawe
虤=haww
虔=hay
皮=hc
颇=hcd
眙=hckg
眸=hct
睃=hcwt
非=hd
睚=hdf
辈=hdh
裴=hdhe
韭=hdhg
蜚=hdhj
剕=hdhj
悲=hdhn
翡=hdhn
棐=hdhs
斐=hdhy
瞭=hdui
眬=hdxy
䴗=hdyg
肯=he
瞍=hehc
瞬=hep
睨=heq
睬=hes
歧=hf
瞌=hfcl
眭=hffg
瞋=hfhw
睹=hft
睦=hfw
盹=hgbn
睛=hge
盱=hgfh
卡=hgh
凸=hghg
芈=hghg
眄=hghn
叔=hgi
督=hgih
忐=hgnu
睐=hgoy
睫=hgv
止=hh
频=hhd
颦=hhdf
目=hhh
步=hhr
瞿=hhw
矍=hhwc
氍=hhwn
眦=hhxn
卜=hhy
瞠=hi
睄=hieg
眇=hitt
旧=hj
卓=hjf
逴=hjfp
桌=hjs
占=hk
战=hka
觇=hkmq
乩=hknn
点=hko
卤=hl
鹾=hlra
贞=hm
卣=hmng
卢=hn
眠=hna
瞰=hnb
鼎=hnd
颅=hndm
凹=hnm
兕=hnmq
鸬=hnqg
瞩=hnt
眯=ho
瞵=hoqh
䁖=hovg
瞎=hp
睿=hpg
壑=hpgf
瞑=hpjw
眈=hpq
餐=hq
粲=hqco
瞻=hqd
眺=hqi
眵=hqqy
盷=hqug
睁=hqv
睥=hr
睎=hrdh
盯=hs
瞟=hsf
瞫=hsjf
睡=ht
眊=htfn
瞅=hto
眨=htp
瞳=hu
睇=hux
眼=hv
具=hw
龄=hwb
龈=hwbe
龌=hwbf
龃=hwbg
龊=hwbh
齿=hwbj
龉=hwbk
龆=hwbk
龅=hwbn
龁=hwbn
龂=hwbr
龇=hwbx
龀=hwbx
龋=hwby
瞪=hwg
睽=hwgd
睑=hwgg
盼=hwv
瞧=hwy
睢=hwyg
此=hx
些=hxf
赀=hxm
觜=hxqh
柴=hxs
雌=hxw
紫=hxx
訾=hxy
眩=hy
江=ia
湛=iad
漭=iada
澌=iadr
淇=iadw
潵=iaet
泔=iafg
洭=iagg
懑=iagn
满=iagw
漠=iaj
灌=iak
潢=iamw
汇=ian
泄=iann
渠=ians
渫=ians
涝=iap
潆=iapi
溁=iaps
滢=iapy
鸿=iaq
沤=iar
柒=ias
浇=iat
沏=iav
潇=iavj
洪=iaw
濩=iawc
溚=iawk
港=iawn
池=ib
滠=ibcc
泐=ibet
洱=ibg
滍=ibhj
涵=ibi
凼=ibk
氾=ibn
漋=ibtg
滁=ibw
汲=iby
汉=ic
泾=ica
渗=icd
涌=ice
泽=icg
治=ick
潏=icnk
滪=icnm
沇=icqn
涘=ictd
滩=icw
浚=icwt
溞=icyj
汊=icyy
尖=id
湖=ide
洧=ideg
沥=idet
涯=idf
溽=idff
洿=idfn
沽=idg
沣=idh
滟=idhc
尜=idiu
淹=idj
湎=idm
源=idr
涛=idt
潦=idui
㵐=iduw
溱=idwt
泷=idxy
汰=idy
㳚=idyy
肖=ie
浮=ieb
淝=iecn
滔=iee
淜=ieeg
沮=ieg
湲=iegc
溲=iehc
削=iej
泇=iekg
逍=iep
潟=ieqo
淫=iet
溪=iex
法=if
灞=ifa
溘=ifcl
沄=ifcy
濡=ifdj
尘=iff
洼=iffg
汗=ifh
汁=ifh
滇=ifhw
潮=ifj
汫=ifjh
瀚=ifjn
洁=ifk
澎=ifke
澍=ifkf
污=ifn
渎=ifnd
渤=ifp
浡=ifpb
瀔=ifpc
溹=ifpi
沅=ifqn
渚=ift
涍=iftb
洘=iftn
漖=iftt
潜=ifw
澪=ifwc
浅=ifx
光=ig
汧=igah
沌=igb
添=igd
清=ige
溥=igef
浦=igey
涿=igey
汪=igg
潖=iggc
沔=igh
漹=igho
洹=igj
浭=igjr
滞=igk
浯=igkg
滆=igkh
涑=igki
濑=igkm
漱=igkw
沛=igm
洓=igmi
漕=igmj
渍=igmy
涞=igo
溍=igoj
耀=igq
洌=igqj
辉=igql
沫=igs
浃=igu
泙=iguf
举=igw
兴=igwu
誉=igwy
小=ih
滤=iha
澽=ihae
滹=ihaf
波=ihc
婆=ihcv
泪=ihg
沚=ihg
淑=ihgc
涉=ihh
濒=ihhm
灈=ihhy
渺=ihi
淖=ihj
沾=ihk
浈=ihmy
泸=ihn
瀣=ihq
濉=ihw
泚=ihxn
水=ii
消=iie
洸=iigq
淼=iii
淌=iim
沙=iit
裟=iite
鲨=iitg
挲=iitr
娑=iitv
温=ij
瀑=ija
沓=ijf
涅=ijfg
浬=ijfg
汨=ijg
汩=ijg
淏=ijgd
湜=ijgh
浉=ijgh
滉=ijiq
漫=ijl
溻=ijng
湿=ijo
渴=ijq
滥=ijt
混=ijx
浊=ijy
灏=ijym
溃=ik
浥=ikcn
涓=ike
呇=ikf
潞=ikhk
浞=ikhy
渑=ikj
澡=ikk
漶=ikkn
涡=ikm
涢=ikmy
渐=il
潩=ilaw
涸=ild
瀱=ildj
洇=ildy
渭=ile
涠=ilfh
泗=ilg
沺=ilg
溷=ilge
澴=ilge
淠=ilgj
洄=ilk
涟=ilp
泅=ilw
漯=ilxi
油=im
澧=ima
淟=imaw
湍=imd
泱=imdy
滑=ime
溅=imf
洞=imgk
涄=imgn
溦=imgt
澂=imgt
汕=imh
测=imj
尚=imk
泂=imkg
氅=imkn
敞=imkt
漴=impi
涔=imw
汭=imwy
漼=imwy
泥=in
泯=ina
湣=inaj
潺=inb
澉=inbt
漏=inf
汛=infh
渥=ing
汈=ingg
湄=inh
湑=inhe
澼=inkf
涮=inm
汜=inn
汤=inr
烫=inro
泼=int
湉=intd
泌=intt
漻=inwe
濯=inwy
沁=iny
浕=inyu
淡=io
渡=ioa
瀍=iojf
瀵=iolw
漉=ion
瀌=iono
潾=ioqh
濂=iou
溏=iov
溇=iovg
洣=ioy
学=ip
黉=ipaw
敩=ipbt
浓=ipe
尝=ipf
淙=ipfi
浣=ipfq
演=ipg
泻=ipgg
渲=ipgg
淀=ipgh
涫=iph
溟=ipj
党=ipk
䣘=ipkb
裳=ipke
堂=ipkf
常=ipkh
赏=ipkm
掌=ipkr
棠=ipks
牚=ipkt
浑=ipl
觉=ipm
峃=ipmj
沈=ipq
涴=ipqb
鲎=ipqg
滨=ipr
泞=ips
喾=iptk
滓=ipu
深=ipw
溶=ipwk
滘=ipwk
沉=ipwn
沱=ipx
沟=iq
泜=iqay
澹=iqd
洈=iqdb
澥=iqeg
淦=iqg
渔=iqgg
澛=iqgj
洮=iqiy
洵=iqj
泃=iqkg
洺=iqkg
浼=iqkq
涣=iqm
泡=iqn
淘=iqr
淴=iqrn
漪=iqt
泖=iqtb
潴=iqtj
㴔=iqvn
汐=iqy
溜=iqyl
汋=iqyy
派=ir
汹=irb
淆=ird
湃=irdf
浠=irdh
泊=irg
湟=irgg
浜=irgw
沂=irh
洙=iriy
汽=irn
浙=irr
溵=irvc
激=iry
河=is
漂=isf
湮=isfg
洒=isg
酒=isgg
汀=ish
湘=ishg
潭=isj
渣=isjg
淅=isr
淋=iss
潸=isse
濋=issh
漤=issv
溧=issy
漆=isw
淞=iswc
沐=isy
沭=isyy
少=it
洚=itah
活=itd
浲=itdh
鋈=itdq
沃=itdy
劣=iter
浩=itf
洗=itfq
省=ith
洎=ithg
濞=ithj
涎=ithp
溴=ithy
潲=itie
浰=itjh
洛=itk
洫=itlg
澳=itm
泺=itni
汔=itnn
潘=ito
渊=itoh
湫=itoy
泛=itp
涐=itry
涤=its
滗=ittn
海=itx
洋=iu
洴=iuah
溯=iub
湔=iuej
泣=iug
溠=iuga
渼=iugd
润=iugg
泮=iugh
澜=iugi
漾=iugi
涧=iuj
潼=iujf
漳=iujf
涪=iuk
湴=iuog
潽=iuoj
浐=iutt
溢=iuw
滋=iux
涕=iuxt
当=iv
溉=ivc
浔=ivfy
汝=ivg
津=ivgh
渌=iviy
沼=ivk
洳=ivkg
淄=ivl
氿=ivn
浸=ivp
染=ivs
梁=ivw
粱=ivwo
涩=ivy
没=iw
沧=iwb
滃=iwcn
洑=iwdy
脊=iwe
鹡=iweg
浍=iwf
漈=iwfi
涂=iwg
瀹=iwga
渰=iwga
溆=iwgc
㽏=iwgf
渝=iwgj
洽=iwgk
潋=iwgt
澄=iwgu
滫=iwhe
浟=iwht
沿=iwk
濮=iwo
滏=iwru
沨=iwry
㳇=iwry
汾=iwv
湓=iwvl
洢=iwvt
浴=iww
沦=iwx
淮=iwy
泠=iwyc
雀=iwyf
浛=iwyk
涨=ix
泓=ixc
沸=ixj
溺=ixu
潍=ixw
沘=ixxn
湝=ixxr
流=iy
淯=iyce
鎏=iycq
㳘=iycq
澈=iyct
瑬=iycy
注=iyg
汴=iyhy
济=iyj
浏=iyjh
淳=iyk
漷=iykb
濠=iyke
瀼=iyke
渟=iyks
澶=iylg
沪=iyn
泳=iyni
瀛=iyny
湾=iyo
滦=iyos
漓=iyr
洲=iyt
游=iytb
浒=iytf
漩=iyth
沩=iyty
滴=iyu
滂=iyuy
浪=iyv
液=iyw
滚=iywe
淬=iywf
沆=iywn
洨=iywr
滧=iywt
淤=iywu
泫=iyxy
澭=iyxy
汶=iyy
是=j
暴=ja
蟒=jad
蜞=jadw
蚶=jafg
虹=jag
螨=jagw
蚜=jah
蜡=jaj
蟆=jajd
蝘=jajv
蜮=jakg
暵=jakw
蟥=jamw
蝶=jan
蠓=jape
蝾=japs
晓=jat
蛲=jatq
蟏=javj
蠖=jawc
最=jb
虸=jbg
蜢=jblg
紧=jc
昪=jcaj
肾=jce
蛹=jceh
坚=jcf
蛏=jcfg
蚂=jcg
贤=jcm
蚆=jcn
蛑=jctg
竖=jcu
晙=jcwt
晨=jd
蝴=jde
蝰=jdff
蛄=jdg
蛎=jdgq
蚌=jdh
晟=jdn
螈=jdri
蝽=jdwj
昃=jdwu
昽=jdxy
明=je
蜉=jebg
暖=jegc
㬊=jegc
蛆=jegg
螋=jehc
盟=jel
暧=jep
曌=jepa
时=jf
野=jfc
蜐=jfce
墅=jfcf
昙=jfcu
里=jfd
蠕=jfdj
蛙=jff
旰=jfh
虷=jfh
昧=jfi
早=jfj
旱=jfj
蟛=jfke
暿=jfkk
蝻=jfmf
暑=jft
蚨=jfwy
量=jg
蛭=jgcf
晊=jgcf
昊=jgd
晴=jge
蜻=jgeg
晡=jgey
旦=jgf
旴=jgfh
旺=jgg
题=jgh
韪=jghh
匙=jghx
虾=jghy
晅=jgjg
蟪=jgjn
晤=jgk
䗖=jgkh
蝲=jgkj
蝠=jgkl
暕=jgli
师=jgm
螬=jgmj
昺=jgmw
蛃=jgmw
蛱=jgud
蚲=jguf
申=jh
勖=jhet
冒=jhf
蠼=jhhc
晫=jhjf
虫=jhn
曰=jhng
畅=jhnr
晃=ji
蛸=jieg
螳=jipf
日=jj
曝=jja
昌=jjf
蛳=jjgh
晶=jjj
蝎=jjq
蜴=jjqr
蜾=jjsy
蝇=jk
蜎=jkeg
蜈=jkg
冔=jkgf
蜗=jkm
曙=jl
曼=jlc
蛊=jlf
蝈=jlg
蛔=jlk
蠋=jlqj
螺=jlx
遇=jm
蛐=jmag
晪=jmaw
映=jmd
蚺=jmfg
蜩=jmfk
蚰=jmg
愚=jmh
帅=jmhh
颙=jmhm
禺=jmhy
旵=jmj
蚬=jmqn
蚋=jmwy
电=jn
暅=jngg
暇=jnh
虬=jnn
遢=jnpd
旸=jnrt
曜=jnwy
昵=jnx
显=jo
晱=jooy
旷=jot
炅=jou
蠊=jouo
蝼=jovg
螗=jovk
晕=jp
暄=jpg
螟=jpj
暝=jpjw
晖=jplh
蜿=jpq
晏=jpv
蛇=jpx
晚=jq
昂=jqb
蟾=jqd
晁=jqi
昫=jqkg
煦=jqko
冕=jqkq
易=jqr
剔=jqrj
昒=jqrt
昴=jqtb
昀=jqug
歇=jqw
鹖=jqwg
曷=jqwn
遏=jqwp
蝗=jr
昄=jrcy
晞=jrdh
蚯=jrgg
昕=jrh
蛛=jri
蜱=jrtf
昳=jrwy
果=js
颗=jsd
螵=jsfi
晒=jsg
蟫=jsjf
夥=jsqq
晰=jsr
蜥=jsrh
杲=jsu
昨=jt
昇=jtaj
蜂=jtd
蛞=jtdg
蜘=jtdk
旿=jtfh
蚝=jtfn
蜓=jtfp
星=jtg
戥=jtga
曛=jtgo
蚱=jthf
晷=jthk
螅=jthn
蜒=jthp
蜊=jtjh
蝮=jtjt
晌=jtm
虼=jtnn
蟠=jtol
蟋=jton
蛾=jtr
䗴=jttp
蝌=jtuf
晦=jtx
临=jty
监=jtyl
鉴=jtyq
览=jtyq
暗=ju
蜷=judb
昱=juf
蚪=jufh
蜣=jufq
曦=jug
蛘=jugh
蟮=jugk
蟑=jujf
暲=jujf
曈=jujf
蜕=juk
蝉=jul
蝤=jusg
螠=juwl
归=jv
旯=jvb
照=jvk
昭=jvkg
蛤=jw
蚣=jwc
昣=jwet
暌=jwgd
蝓=jwgj
蜍=jwgs
䗛=jwhe
蚧=jwjh
虮=jwn
晔=jwx
晗=jwy
蛉=jwyc
昤=jwyc
暹=jwyp
昆=jx
曳=jxe
蚴=jxet
蚓=jxh
鹍=jxxg
蚍=jxxn
㬎=jxxo
景=jy
㬚=jyct
蛀=jyg
蛴=jyjh
影=jyk
曩=jyke
晾=jyki
颢=jykm
暾=jykt
蝙=jyna
虻=jynn
昈=jynt
晐=jynw
蚁=jyr
螭=jyrc
昉=jyt
蚄=jyt
蝣=jytb
暶=jyth
旻=jyu
螃=jyuy
螂=jyvb
㫰=jyve
蛟=jyw
蟀=jyxf
昡=jyxy
蚊=jyy
中=k
呀=ka
嘶=kad
喏=kadk
哐=kagg
噶=kaj
嘞=kak
喵=kalg
咂=kamh
唝=kamy
呓=kan
喋=kans
唠=kap
哎=kar
呕=kary
哓=katq
哄=kaw
嚄=kawc
嗬=kawk
嗒=kawk
嚆=kayk
啊=kb
嗫=kbc
咡=kbg
叩=kbh
嗤=kbhj
咄=kbm
吼=kbn
戢=kbxy
吸=kby
吧=kc
邑=kcb
嗓=kcc
啜=kccc
嗵=kce
吗=kcg
咍=kckg
吮=kcq
唉=kct
哞=kctg
唆=kcw
叹=kcy
顺=kd
呃=kdb
呖=kdet
喹=kdff
咕=kdg
喊=kdgy
嘎=kdh
呸=kdhg
嗄=kdht
嘁=kdhy
喱=kdj
唵=kdjn
咴=kdoy
哒=kdpy
嘹=kdu
噘=kduw
唪=kdwg
嗪=kdwt
咙=kdx
吠=kdy
呔=kdyy
另=ke
咀=keg
嗖=keh
别=kej
咖=kek
嚼=kel
嗳=kep
鹃=keq
叻=ket
叶=kf
喷=kfa
吱=kfc
嗑=kfcl
嚅=kfdj
哇=kff
吐=kfg
嗔=kfhw
味=kfi
嘲=kfj
嘻=kfk
嘭=kfke
鄙=kfl
喃=kfm
哧=kfoy
嗦=kfp
哱=kfpb
嚏=kfph
噎=kfpu
呒=kfqn
嗜=kft
嘟=kftb
哮=kftb
啫=kftj
呋=kfwy
嚯=kfwy
号=kg
哢=kgah
吨=kgb
郢=kgbh
咥=kgcf
吴=kgd
哺=kge
啄=kgey
呈=kgf
吁=kgfh
吓=kgh
哽=kgj
咺=kgjg
嗽=kgk
囔=kgke
唔=kgkg
嗝=kgkh
喇=kgkj
嘈=kgm
啧=kgmy
饕=kgne
鸮=kgng
哑=kgo
逞=kgp
咧=kgq
嗷=kgqt
唛=kgty
咦=kgx
嗉=kgxi
距=kha
噱=khae
嘘=khag
躇=khaj
跷=khaq
蹀=khas
唬=khaw
蹒=khaw
躏=khay
蹑=khbc
趿=khby
踊=khc
跆=khck
蹂=khcs
跨=khd
啡=khdd
踌=khdf
蹰=khdf
跖=khdg
蹽=khdi
踦=khdk
跶=khdp
蹶=khdw
跋=khdy
踩=khe
蹊=khed
蹈=khee
啃=kheg
跏=khek
践=khf
跂=khfc
跬=khff
跱=khff
趺=khfw
贵=khg
趼=khga
咔=khgh
遗=khgp
遣=khgp
趾=khh
跛=khhc
踔=khhf
跐=khhx
踏=khi
蹐=khie
蹚=khif
踢=khj
踶=khjh
蹋=khjn
踝=khjs
躁=khks
盅=khl
躅=khlj
蹦=khm
跚=khmg
踹=khmj
忠=khn
踞=khnd
跽=khnn
踱=kho
躔=khof
踮=khok
蹼=khow
踪=khp
蹿=khph
蹜=khpj
跎=khpx
跑=khq
跪=khqb
跳=khqi
趵=khqy
跌=khr
踬=khrm
蹅=khsg
跃=kht
踵=khtf
鹭=khtg
跞=khti
路=khtk
踟=khtk
蹯=khtl
躜=khtm
跹=khtp
跣=khtq
踒=khtv
踽=khty
足=khu
蹉=khua
踯=khub
蹲=khuf
蹭=khuj
踣=khuk
跟=khv
躐=khvn
踺=khvp
趴=khw
啮=khwb
跄=khwb
跗=khwf
跺=khws
蹬=khwu
嘴=khx
跸=khxf
呲=khxn
卟=khy
蹁=khya
躞=khyc
蹢=khyd
踉=khye
蹄=khyh
跻=khyj
跤=khyr
蹾=khyt
蹴=khyy
吵=ki
哨=kie
咣=kig
啵=kihc
唢=kim
嘡=kipf
嗨=kitx
虽=kj
嘬=kjbc
哩=kjf
呻=kjh
唱=kjj
喁=kjmy
黾=kjnb
喝=kjq
吕=kk
嚚=kkak
骂=kkc
器=kkd
嚣=kkdk
哭=kkdy
鄂=kkfb
鹗=kkfg
颚=kkfm
串=kkh
患=kkhn
品=kkk
口=kkkk
噪=kkks
鼍=kkln
斝=kkpf
咒=kkw
喂=kl
咽=kld
嗯=kldn
喟=kle
嘿=klf
啭=klfy
呷=klh
啰=klqy
员=km
嗣=kma
郧=kmb
喘=kmd
咉=kmdy
勋=kme
嘣=kmee
啁=kmfk
哃=kmg
吊=kmh
嘤=kmm
哕=kmqy
呐=kmw
剐=kmwj
呙=kmwu
呗=kmy
叫=kn
哪=kng
喔=kngf
叼=kngg
噼=knk
唰=knm
噀=knnw
嘱=knt
咇=kntt
呢=knx
吣=kny
嘛=ko
噗=kog
啖=koo
喽=kov
咪=koy
喧=kp
噻=kpa
嗐=kpdk
哝=kpe
啶=kpgh
嘧=kpn
咛=kps
喀=kpt
咤=kpta
嚓=kpw
兄=kq
噜=kqg
唤=kqm
呜=kqn
咆=kqnn
哆=kqq
吻=kqr
啕=kqrm
唿=kqrn
吹=kqw
鸣=kqy
听=kr
唣=kran
呱=krcy
唏=krd
嗥=krdf
哌=krey
喤=krgg
史=kri
啪=krr
哳=krrh
啤=krt
啦=kru
呆=ks
嘌=ksfi
哂=ksg
叮=ksh
喳=ksj
呵=ksk
噤=kss
啉=kssy
吃=kt
噬=kta
吒=ktan
唾=ktf
吽=ktgh
咱=kth
咋=kthf
川=kthh
嗅=kthy
嘚=ktjf
咯=ktk
响=ktm
噢=ktmd
啾=kto
哦=ktr
呼=ktu
咚=ktuy
噫=ku
嗍=kube
嗟=kug
咩=kugh
吖=kuh
噇=kujf
喑=kujg
啴=kulh
噌=kulj
㘎=kunt
噂=kusf
唼=kuvg
嗌=kuwl
嗞=kuxx
啸=kv
唧=kvc
呶=kvcy
哏=kvey
叨=kvt
只=kw
呛=kwb
嗡=kwc
啥=kwf
哙=kwfc
咐=kwfy
哈=kwg
喻=kwgj
噔=kwgu
叽=kwn
喉=kwnd
嗲=kwr
㕮=kwry
咻=kws
哚=kwsy
吩=kwv
咿=kwvt
唑=kwwf
哗=kwx
叭=kwy
噙=kwyc
呤=kwyc
唯=kwyg
吟=kwyn
噍=kwyo
哟=kx
呦=kxe
喙=kxge
吲=kxhh
叱=kxn
哔=kxx
咝=kxxg
吡=kxxn
喈=kxxr
吆=kxy
呣=kxy
咬=ky
唷=kyc
唁=kyg
嚷=kyk
哼=kykb
嚎=kyke
咳=kyn
咏=kyni
唳=kyny
嗾=kytd
啼=kyu
嘀=kyud
啷=kyv
吭=kyw
啐=kywf
国=l
羁=la
轼=laa
辄=lb
墼=lbwf
轻=lc
轰=lcc
辍=lccc
畯=lcwt
因=ld
轭=ldb
固=ldd
囿=lde
罟=ldf
轱=ldg
罘=ldh
罨=ldjn
恩=ldn
罽=ldoj
畸=lds
畴=ldt
辏=ldwd
轪=ldy
畎=ldyy
男=le
胃=lef
团=lf
罢=lfc
罴=lfco
畦=lff
畤=lffy
轩=lfh
置=lfhf
辕=lfk
罱=lfmf
转=lfn
围=lfnh
黑=lfo
黩=lfod
黝=lfoe
黪=lfoe
墨=lfof
黥=lfoi
黯=lfoj
黠=lfok
黜=lfom
黔=lfon
黟=lfoq
黢=lfot
默=lfoy
园=lfq
署=lft
圉=lfuf
车=lg
囤=lgb
轾=lgcf
辅=lge
圊=lged
畏=lgeu
圃=lgey
罡=lghf
畀=lgjj
辐=lgk
圄=lgkd
鹮=lgkg
翾=lgkn
辆=lgm
四=lh
罪=lhd
罩=lhj
甲=lhn
皿=lhng
轳=lhnt
辊=lj
辒=ljlg
回=lk
辑=lkb
圆=lkm
轵=lkwy
田=ll
圜=llg
〇=llll
罍=lllm
圐=llye
轴=lm
圌=lmdj
辋=lmun
思=ln
辗=lna
翈=lng
轧=lnn
疁=lnwe
罹=lnwy
辘=lo
辚=loq
连=lp
辖=lpd
畹=lpqb
罗=lq
蜀=lqj
逻=lqp
囫=lqr
软=lqw
鸭=lqy
罶=lqyl
斩=lr
畈=lrc
畖=lrcy
堑=lrf
暂=lrj
錾=lrq
椠=lrsu
轶=lrw
困=ls
町=lsh
轲=lsk
图=lt
轿=ltd
辀=ltey
囷=lti
略=ltk
辂=ltkg
轹=ltni
轷=ltuf
畋=lty
圈=lu
畔=lug
疃=lujf
罾=lulj
轨=lv
囡=lvd
轺=lvkg
辎=lvl
轫=lvyy
界=lw
圙=lwdd
轸=lwet
畛=lwet
输=lwg
辁=lwgg
囚=lwi
轮=lwx
囵=lwxv
囹=lwyc
累=lx
毗=lxx
辔=lxxk
较=ly
辙=lyc
詈=lyf
罚=lyj
辌=lyki
同=m
曲=ma
嵁=madn
贼=madt
嵌=maf
岈=maht
岽=maiu
岠=mang
嵘=map
崂=mape
㠓=mape
岖=mar
峣=matq
典=maw
邮=mb
崡=mbib
岌=mby
峻=mc
岜=mcb
峄=mcgh
贻=mck
央=md
贿=mde
岩=mdf
赈=mdfe
崖=mdff
岸=mdfj
岵=mdg
崴=mdgy
嵅=mdgy
酆=mdhb
崦=mdjn
盎=mdl
耑=mdmj
颛=mdmm
遄=mdmp
炭=mdo
鸯=mdq
崎=mds
骨=me
髓=med
骷=medg
崩=mee
胄=mef
岨=megg
髁=mejs
髃=mejy
髑=melj
髎=mene
髅=meo
髋=mep
髂=mepk
髌=mepw
鹘=meqg
骶=meqy
髀=merf
骺=merk
骼=met
骰=mewc
骱=mewj
骸=mey
周=mf
岐=mfc
冉=mfd
峙=mff
崶=mfff
赋=mfh
巅=mfhm
雕=mfk
赎=mfn
䎃=mfng
崁=mfqw
财=mft
赌=mftj
崚=mfwt
贱=mfx
峡=mg
岍=mgah
赙=mge
豳=mgee
赇=mgiy
峘=mgjg
峿=mgkg
屿=mgn
崃=mgoy
峛=mgqj
屼=mgqn
由=mh
巇=mhaa
幪=mhae
帱=mhdf
帏=mhf
幅=mhg
帻=mhgm
帖=mhh
帔=mhhc
帧=mhhm
帽=mhj
幔=mhjc
幌=mhjq
巾=mhk
贴=mhkg
帜=mhkw
帼=mhl
幄=mhnf
贝=mhny
幞=mhow
帕=mhr
帙=mhrw
幖=mhsi
帐=mht
幡=mhtl
幢=mhu
帡=mhua
幛=mhuf
帨=mhuq
帆=mhw
帷=mhwy
峭=mi
嵴=miwe
则=mj
赗=mjhg
嵎=mjmy
赐=mjq
岿=mjv
迥=mk
崿=mkkn
贶=mkqn
崭=ml
崮=mldf
岬=mlh
崽=mln
山=mm
赒=mmfk
册=mmg
岫=mmg
删=mmgj
峒=mmgk
屾=mmh
赑=mmmu
岘=mmqn
岗=mmr
罂=mmrm
婴=mmv
鹦=mmvg
岂=mn
岷=mna
崛=mnbm
崌=mndg
㟃=mngk
嵋=mnh
剀=mnjh
觊=mnm
屺=mnn
嶍=mnrg
凯=mnw
赆=mnyu
赃=mo
赕=mooy
嶙=moq
嵝=movg
迪=mp
崇=mpf
贮=mpg
辿=mpk
崆=mpwa
见=mq
觃=mqbd
购=mqc
赡=mqd
峗=mqdb
嶦=mqdy
崟=mqf
峋=mqjg
刿=mqjh
岣=mqkg
巉=mqky
翙=mqng
嵚=mqqw
峁=mqtb
岁=mqu
峥=mqv
刚=mr
贩=mrc
崤=mrde
冈=mri
嵬=mrq
网=mrr
岢=ms
嵖=msjg
崾=msvg
崧=mswc
败=mt
账=mta
峰=mtd
峤=mtdj
岞=mthf
嵲=mths
赂=mtk
屹=mtn
嶓=mtol
贬=mtp
峨=mtr
嵊=mtux
峂=mtuy
巍=mtv
赠=mu
嵯=mug
嶂=muj
赔=muk
嶒=mulj
嶟=musf
赚=muv
嵫=muxx
罔=muyn
内=mw
赊=mwf
崄=mwgg
嵛=mwgj
嶝=mwgu
冏=mwkd
岚=mwr
肉=mww
峪=mwwk
岭=mwy
酅=mwyb
崔=mwyf
嶲=mwym
岑=mwyn
幽=mx
嶷=mxth
丹=my
彤=mye
嵩=myk
崞=mykb
㠇=myky
赅=myn
崀=myve
崒=mywf
峧=mywr
民=n
展=na
悈=naah
惬=nagd
异=naj
羿=naj
惜=najg
慬=nakg
懵=nal
屉=nan
怄=nary
懂=nat
愍=natn
殿=naw
臀=nawe
慌=nay
敢=nb
孱=nbbb
慑=nbc
屈=nbm
屙=nbsk
憨=nbtn
怪=nc
惙=nccc
惨=ncd
怿=ncgh
怡=nck
悛=ncwt
居=nd
惰=nda
恹=nddy
怙=ndg
憾=ndgn
怀=ndh
剧=ndj
怖=ndm
愐=ndmd
忧=ndn
恢=ndo
憭=ndui
慆=neeg
导=nf
愤=nfa
层=nfc
恸=nfce
厾=nfci
怯=nfcy
忮=nfcy
懦=nfdj
恃=nff
慎=nfh
慰=nfi
尉=nfif
螱=nfij
熨=nfio
迅=nfp
悖=nfpb
怃=nfqn
屠=nft
愭=nftj
悻=nfuf
㥄=nfwt
忖=nfy
那=ng
忳=ngbn
屋=ngc
刁=ngd
情=nge
怔=ngh
恒=ngj
司=ngk
悟=ngkg
悚=ngki
懒=ngkm
怦=ngu
愫=ngx
收=nh
郿=nhbh
眉=nhd
戕=nhda
奘=nhdd
悱=nhdd
爿=nhde
牂=nhdg
牁=nhdk
胥=nhe
丑=nhf
叚=nhfc
遐=nhfp
蛋=nhj
悼=nhjf
疍=nhjg
鹛=nhqg
惧=nhw
疏=nhy
尿=ni
屑=nie
悄=nieg
恍=nig
惝=nimk
犀=nit
慢=nj
悭=njcf
悍=njf
悝=njfg
怛=njgg
愠=njlg
惕=njq
惺=njt
憬=njy
避=nk
悒=nkcn
忡=nkh
翀=nkhh
愦=nkhm
愕=nkkn
壁=nku
臂=nkue
襞=nkue
辟=nkuf
䴙=nkug
鐾=nkuq
擘=nkur
檗=nkus
劈=nkuv
嬖=nkuv
譬=nkuy
璧=nkuy
甓=nkuy
惭=nl
翼=nla
悃=nlsy
愣=nly
届=nm
惴=nmdj
怏=nmdy
惆=nmf
恫=nmg
刷=nmh
屃=nmi
恻=nmj
恺=nmn
惘=nmu
已=nn
巽=nnaw
己=nng
巳=nngn
尸=nngt
书=nnh
忸=nnhf
局=nnk
乙=nnl
忆=nnn
忌=nnu
乜=nnv
快=nnw
怩=nnxn
羽=nny
屡=no
惦=noh
屎=noi
惔=nooy
慷=nov
慵=novh
忱=np
悰=npfi
愃=npgg
恽=npl
翚=nplj
惋=npq
懈=nq
惛=nqaj
憺=nqdy
恂=nqjg
惚=nqr
㤘=nqvg
忺=nqwy
鸤=nqyg
怕=nr
惶=nrgg
忻=nrh
忾=nrn
愧=nrq
怵=ns
恓=nsg
憷=nssh
必=nt
怅=ntay
悸=ntb
邲=ntbh
发=ntc
恬=ntd
尾=ntf
屐=ntfc
忏=ntfh
忤=ntfh
慥=ntfp
性=ntg
怍=nthf
屣=nthh
虱=ntj
愎=ntjt
属=ntk
恪=ntkg
恤=ntl
懊=ntm
屦=ntov
愀=ntoy
履=ntt
悔=ntx
改=nty
习=nu
屏=nua
买=nudu
翌=nuf
羼=nugg
飞=nui
憧=nujf
愔=nujg
悦=nuk
憎=nul
惮=nulh
慊=nuvo
悌=nux
悯=nuy
恨=nv
慨=nvc
怊=nvkg
忉=nvt
尻=nvv
惟=nw
怆=nwb
忪=nwcy
戮=nwe
勠=nwee
鹨=nweg
恰=nwg
愉=nwgj
憕=nwgu
夬=nwi
翂=nwvt
怜=nwy
戳=nwya
翟=nwyf
憔=nwyo
惯=nx
怫=nxjh
尼=nxv
屁=nxx
心=ny
忭=nyhy
尺=nyi
昼=nyj
惊=nyk
惇=nykb
翯=nykk
咫=nykw
懔=nyli
忙=nyn
迟=nyp
恼=nyr
尽=nyu
悢=nyve
翠=nyw
悴=nywf
恔=nywr
为=o
度=oa
煁=oadn
煤=oaf
廑=oakg
爟=oaky
席=oam
炼=oan
炬=oang
庹=oany
遮=oao
鹧=oaog
庶=oaoi
䗪=oaoj
烧=oat
糒=oath
粪=oaw
烘=oawy
籽=ob
邝=obh
鬯=obxb
序=oc
烃=oca
糁=ocde
熥=ocep
粑=ocn
燏=ocnk
糅=ocns
焌=ocwt
类=od
糊=ode
煳=odeg
烠=odeg
煃=odff
炻=odg
粝=odgq
庆=odi
庵=odjn
烦=odm
燎=odui
庞=odx
粗=oe
廋=oehc
㶲=oehh
爝=oelf
庾=oewi
庄=of
庋=ofci
糯=ofdj
庤=offi
灶=ofg
炜=ofnh
庑=ofqv
烤=oft
庱=ofwt
㸌=ofwy
业=og
邺=ogbh
炖=ogbn
精=oge
粳=ogj
烜=ogjg
焐=ogkg
糟=ogm
炳=ogmw
廒=ogqt
凿=ogu
黹=ogui
黻=oguy
黼=oguy
店=oh
焯=ohjf
粘=ohk
应=oi
炒=oit
烛=oj
爆=oja
焊=ojf
廛=ojff
炟=ojgg
煴=ojlg
粿=ojsy
煋=ojtg
煜=ojug
焜=ojxx
燥=ok
焆=okeg
炽=okw
烟=ol
廙=olaw
煟=oleg
煨=olge
库=olk
庙=om
煓=omdj
烔=omgk
灿=omh
籼=omh
炯=omk
断=on
糈=onhe
鹿=onj
鄜=onjb
麝=onjf
麈=onjg
麟=onjh
麖=onji
麋=onjo
鏖=onjq
麑=onjq
麇=onjt
麂=onjw
麒=onjw
麀=onjx
焗=onn
熠=onrg
炀=onrt
废=ont
廖=onw
炔=onwy
烬=ony
火=oo
郯=oobh
剡=oojh
燚=oooo
燊=ooos
焱=ooou
欻=ooqw
炎=oou
糖=oov
糠=oovi
迷=op
烷=opf
粽=opfi
煊=opg
熔=opw
底=oq
粼=oqab
翷=oqan
遴=oqap
燃=oqd
焰=oqe
廨=oqeg
焕=oqm
炮=oqn
庖=oqnv
炊=oqw
灼=oqy
熘=oqyl
煌=or
烯=ord
粕=org
炘=orh
廆=orqc
庳=ortf
灯=os
熛=osfi
粞=osg
床=osi
炣=oskg
麻=oss
魔=ossc
麽=ossc
磨=ossd
靡=ossd
縻=ossi
麾=ossn
糜=osso
摩=ossr
庭=ot
烽=otd
糙=otf
㸆=otfd
烶=otfp
炸=oth
糌=othj
熄=othn
烻=othp
糗=othy
烙=otk
熜=otln
燠=otmd
烁=otn
燔=otol
烀=otuf
敉=oty
料=ou
烂=oud
燧=ouep
粒=oug
烊=ough
庠=ougk
糕=ougo
爔=ougy
焙=ouk
焖=oun
廉=ouv
糍=ouxx
数=ov
庸=ove
鄘=oveb
煺=ovep
娄=ovf
唐=ovh
鄌=ovhb
康=ovi
庚=ovw
鹒=ovwg
赓=ovwm
府=ow
炝=owbn
煅=owd
腐=owf
烩=owfc
爚=owga
熻=owgn
炌=owjh
糇=ownd
庥=ows
粉=owv
座=oww
膺=owwe
鹰=owwg
烨=owxf
焓=owy
燋=owyo
庇=ox
庼=oxdm
糨=oxk
广=oy
炷=oygg
廓=oyk
焞=oykb
熇=oykk
廪=oyl
炉=oyn
煸=oyna
庐=oyne
煽=oynn
米=oyt
熵=oyu
粮=oyv
廊=oyvb
烺=oyve
粹=oyw
炕=oywn
炫=oyx
炆=oyy
这=p
宽=pa
宦=pah
宧=pahh
寞=paj
赛=paw
褰=pawe
塞=pawf
骞=pawg
蹇=pawh
搴=pawr
寨=paws
寒=pawu
謇=pawy
字=pb
害=pd
宏=pdc
寡=pde
宥=pdef
宕=pdf
宸=pdfe
割=pdh
豁=pdhk
宬=pdny
寄=pds
寮=pdui
宠=pdx
农=pe
宜=peg
守=pf
宗=pfi
完=pfq
寇=pfqc
冠=pfqf
定=pg
室=pgc
家=pge
冢=pgey
宇=pgf
宣=pgj
富=pgk
寅=pgm
戭=pgma
写=pgn
寁=pgvh
宝=pgy
官=ph
寂=phg
逭=phnp
宵=pi
审=pj
幂=pjd
寓=pjm
宴=pjv
冥=pjy
宫=pk
军=pl
郓=plb
寰=plg
皲=plhc
宙=pm
密=pn
甯=pne
寐=pnh
寤=pnhk
蜜=pnt
宓=pntr
寥=pnw
灾=po
之=pp
冤=pq
宛=pqb
剜=pqbj
鸩=pqq
宾=pr
宁=ps
宋=psu
客=pt
宅=pta
宪=ptf
牢=ptg
额=ptk
实=pu
褡=puak
衩=puc
裰=pucc
褥=pudf
襫=pudj
衫=pue
衬=puf
袪=pufc
褂=pufh
袆=pufh
宰=pufj
褚=pufj
襦=pufj
袜=pug
裱=puge
被=puh
补=puhy
裆=pui
裸=puj
袒=pujg
褴=pujl
褐=pujn
褟=pujn
裼=pujr
裎=pukg
裢=pulp
袖=pum
衲=pumw
褶=pun
裾=pund
袂=punw
袯=puny
裤=puo
褯=puoh
褛=puov
裈=pupl
袍=puq
襜=puqy
裨=pur
褫=purw
襟=pus
襻=pusr
袄=put
衽=putf
袼=putk
褙=puue
袢=puug
襕=puui
裥=puuj
襚=puup
初=puv
寝=puvc
裉=puve
裙=puvk
褪=puvp
裕=puw
袗=puwe
裣=puwg
褕=puwj
袷=puwk
衿=puwn
褓=puws
袱=puwy
襁=puxj
褊=puya
安=pv
宄=pvb
案=pvs
空=pw
穿=pwa
窍=pwan
窃=pwav
窿=pwb
冗=pwb
突=pwd
宿=pwdj
穷=pwe
察=pwf
窦=pwfd
罕=pwfj
窥=pwfq
窒=pwg
窀=pwgn
窅=pwhf
窠=pwj
窝=pwk
窜=pwkh
帘=pwm
窟=pwn
窭=pwov
窕=pwq
窎=pwqg
穸=pwqu
窑=pwr
窳=pwry
窊=pwry
窗=pwt
窄=pwtf
窖=pwtk
窸=pwtn
穴=pwu
窨=pwuj
邃=pwup
究=pwv
窘=pwvk
容=pww
窬=pwwj
穹=pwx
窈=pwxe
鹤=pwy
隺=pwyd
窣=pwyf
它=px
社=py
祺=pya
祁=pyb
祃=pycg
祷=pyd
禊=pydd
祜=pydg
祏=pydg
祐=pydk
祓=pydy
祖=pye
祛=pyfc
祎=pyfh
禧=pyfk
祾=pyft
禛=pyfw
福=pyg
祆=pygd
祉=pyhg
祯=pyhm
神=pyj
禔=pyjh
祼=pyjs
祝=pyk
祸=pykw
禤=pyln
视=pym
礼=pyn
祠=pynk
祀=pynn
祕=pynt
祗=pyq
祇=pyqa
祢=pyqi
祧=pyqi
祈=pyr
禋=pysf
祚=pyt
祥=pyu
禅=pyul
禚=pyuo
禄=pyv
祲=pyvc
祋=pywc
禒=pyxe
禳=pyye
禘=pyyh
祊=pyyt
我=q
错=qa
锘=qadk
钳=qaf
䦃=qafj
铘=qahb
舛=qahh
桀=qahs
昏=qaj
镆=qajd
钷=qakg
锚=qal
锳=qamd
钜=qan
铽=qany
铹=qap
铙=qat
氏=qav
镬=qaw
邸=qay
鸱=qayg
氐=qayi
迎=qb
镊=qbc
铒=qbg
钌=qbh
卬=qbh
眢=qbhf
锰=qbl
怨=qbn
鸳=qbq
锕=qbsk
色=qc
铎=qcg
勾=qci
钯=qcn
钗=qcy
然=qd
危=qdb
钹=qdcy
铕=qdeg
锛=qdfa
钴=qdg
锲=qdh
钚=qdhy
铖=qdny
锜=qdsk
铸=qdt
镣=qdu
镢=qduw
詹=qdw
钛=qdyy
解=qe
锊=qefy
钥=qeg
锾=qegc
锄=qege
角=qeh
锼=qehc
斛=qehf
觟=qehf
觫=qehi
触=qehj
蟹=qehj
觭=qehk
觿=qehk
觯=qehl
邂=qehp
觥=qehq
觞=qehr
觖=qehw
觚=qehy
鹐=qeqg
钐=qet
钱=qf
钍=qfg
针=qfh
镇=qfhw
镭=qfl
锗=qft
铐=qftn
铑=qftx
印=qg
鳠=qgac
鳓=qgae
钘=qgah
铏=qgaj
鲽=qgas
鲯=qgaw
钝=qgb
鲰=qgbc
鲹=qgce
铚=qgcf
鲬=qgch
鲐=qgck
鲃=qgcn
鱿=qgd
鲔=qgde
鲕=qgdj
䲠=qgdj
鳡=qgdn
鳜=qgdw
鲅=qgdy
铺=qge
镈=qgef
锖=qgeg
鳐=qgem
鲵=qgeq
匍=qgey
鱼=qgf
鲑=qgff
鳍=qgfj
鲒=qgfk
鲼=qgfm
鲮=qgft
鳕=qgfv
鲭=qgge
鲆=qggf
鲾=qggl
鲀=qggn
鲠=qggr
鲡=qggy
钙=qgh
鲏=qghc
鲱=qghd
钲=qghg
鲇=qghk
鲈=qghn
鲿=qgic
鲁=qgj
鳗=qgjc
鲤=qgjf
鲥=qgjf
鲣=qgjf
鳀=qgjh
鲳=qgjj
鳁=qgjl
鳎=qgjn
鲲=qgjx
鳄=qgk
铻=qgkg
镉=qgkh
匐=qgkl
鳃=qgl
鲴=qgld
鳂=qgle
鳏=qgli
鲢=qglp
鲉=qgmg
鲗=qgmj
鲷=qgmk
鲖=qgmk
鳢=qgmu
鳚=qgnf
鲺=qgnj
鱾=qgnn
鳛=qgnr
钺=qgny
鳞=qgo
鳙=qgoh
铼=qgoy
鲩=qgp
鲍=qgq
䲟=qgqb
鳇=qgrg
鲌=qgrg
鳈=qgri
鲘=qgrk
鳔=qgs
鲊=qgtf
鲧=qgti
鳤=qgtn
鳅=qgto
鲦=qgts
稣=qgty
鿏=qgty
鲜=qgu
铗=qgud
鳟=qguf
鳉=qguf
鳝=qguk
鳒=qguo
鲫=qgv
鲟=qgvf
鲪=qgvk
鲻=qgvl
鱽=qgvt
鲋=qgw
鲙=qgwc
鲸=qgy
鳊=qgya
鳣=qgyg
鲚=qgyj
鲛=qgyr
鲂=qgyt
钰=qgyy
鳑=qgyy
外=qh
铍=qhcy
钼=qhg
钻=qhk
钋=qhy
销=qi
鼗=qifc
玺=qig
兆=qii
锁=qim
铴=qinr
逃=qip
镗=qipf
迩=qipi
镋=qipq
钞=qit
尔=qiu
铛=qiv
旬=qj
郇=qjbh
铿=qjc
锂=qjf
锝=qjgf
钽=qjgg
钊=qjh
镘=qjlc
龟=qjn
锡=qjq
锞=qjsy
锟=qjx
名=qk
句=qkd
象=qke
劬=qket
锃=qkgg
钏=qkh
钟=qkhh
铝=qkk
锷=qkkn
锅=qkm
铞=qkmh
够=qkq
免=qkqb
勉=qkqe
鸲=qkqg
逸=qkqp
兔=qkqy
雊=qkwy
甸=ql
锢=qldg
铟=qldy
钿=qlg
镮=qlge
钾=qlh
锶=qlny
链=qlp
锣=qlq
镯=qlqj
负=qm
奂=qmdu
镚=qmee
铀=qmg
铜=qmgk
铡=qmj
铠=qmnn
钢=qmr
钠=qmw
夐=qmwt
钡=qmy
饭=qn
饶=qna
馍=qnad
馑=qnag
馓=qnat
饵=qnbg
饳=qnbm
饴=qnc
锯=qnd
馁=qne
馊=qnec
饯=qnf
饽=qnfb
馌=qnfl
乌=qng
邬=qngb
馕=qnge
饨=qngn
钮=qnhf
镅=qnhg
蚀=qnj
馒=qnjc
刨=qnjh
馃=qnjs
馄=qnjx
馈=qnk
馉=qnme
钇=qnn
钆=qnn
饲=qnnk
锔=qnnk
饧=qnnr
馔=qnnw
馆=qnp
饮=qnq
馅=qnqe
馏=qnql
饱=qnqn
馋=qnqu
饩=qnrn
钖=qnrt
馇=qnsg
饰=qnt
饫=qntd
饬=qnte
饪=qntf
饷=qntk
饹=qntk
铋=qntt
饿=qnty
䥽=qnty
饼=qnu
馐=qnuf
包=qnv
饥=qnw
镠=qnwe
饸=qnwk
铌=qnxn
饺=qny
饻=qnye
炙=qo
镀=qoa
镤=qogw
镳=qono
锬=qooy
镰=qouo
镂=qov
镛=qovh
钬=qoy
锭=qp
镓=qpge
夤=qpgw
镔=qprw
铵=qpvg
镩=qpwh
镲=qpwi
镕=qpwk
铊=qpxn
多=qq
钩=qqc
铯=qqcn
镥=qqgj
铫=qqiy
铭=qqk
镵=qqky
钨=qqn
金=qqq
鑫=qqqf
锪=qqrn
铆=qqt
钧=qqug
铮=qqvh
钦=qqw
钓=qqy
镏=qqyl
铁=qr
匈=qrb
钣=qrcy
勿=qre
锧=qrfm
铂=qrg
锽=qrgg
铢=qriy
刎=qrjh
锦=qrm
忽=qrn
锨=qrq
铩=qrsy
匆=qry
钉=qs
镖=qsf
钵=qsg
镡=qsjf
儿=qt
猎=qta
狨=qtad
獴=qtae
猫=qtal
獾=qtay
犯=qtb
卯=qtbh
狲=qtbi
猛=qtbl
锈=qtbt
犸=qtcg
狁=qtcq
猱=qtcs
狻=qtct
锋=qtd
猰=qtdd
猢=qtde
狉=qtdg
獠=qtdi
猗=qtdk
獗=qtdw
犹=qtdy
狙=qte
猺=qtem
猊=qteq
猪=qtf
铥=qtfc
猿=qtfe
锸=qtfe
锤=qtfg
钎=qtfh
犴=qtfh
锆=qtfk
铤=qtfp
铣=qtfq
橥=qtfs
狂=qtg
狭=qtgd
猜=qtge
锺=qtgf
獭=qtgm
逛=qtgp
镍=qth
玃=qthc
猇=qthw
独=qtj
狸=qtjf
猩=qtjg
狮=qtjh
猖=qtjj
铬=qtk
狷=qtke
猥=qtle
猬=qtle
狎=qtlh
猡=qtlq
猾=qtm
猯=qtmj
狈=qtmy
狃=qtnf
铄=qtni
峱=qtnm
夕=qtny
狄=qto
逖=qtop
犷=qtot
锹=qtoy
狞=qtp
狩=qtpf
狗=qtq
獬=qtqg
狰=qtqh
狝=qtqi
狍=qtqn
狐=qtr
锇=qtry
猹=qtsg
猁=qttj
獯=qtto
獐=qtuf
獍=qtuq
狠=qtv
卿=qtvb
犰=qtvn
猴=qtw
狯=qtwc
猃=qtwg
㺄=qtwj
猞=qtwk
狳=qtws
狒=qtx
狴=qtxf
猕=qtxi
狼=qty
猝=qtyf
狺=qtyg
猄=qtyi
狡=qtyr
狱=qtyy
匀=qu
锩=qudb
锌=quf
钭=qufh
镁=qug
锎=quga
镧=qugi
镜=quj
锏=qujg
镱=qujn
锐=quk
锫=qukg
钔=qun
镨=quoj
锵=quq
铲=qut
镒=quwl
锑=qux
镃=quxx
争=qv
邹=qvb
银=qve
刍=qvf
钕=qvg
键=qvgp
皱=qvhc
铷=qvkg
锱=qvlg
镴=qvln
急=qvn
锓=qvpc
煞=qvt
雏=qvw
欠=qw
锻=qwd
铨=qwgg
铪=qwgk
镎=qwgr
镫=qwgu
铅=qwk
锉=qww
铧=qwxf
铃=qwy
镌=qwyb
飧=qwye
锥=qwyg
钤=qwyn
钒=qwyy
锴=qx
镄=qxjm
镪=qxkj
久=qy
锍=qyck
铳=qycq
訇=qyd
铱=qye
勺=qyi
镶=qyk
锿=qyke
镐=qykk
镦=qykt
铈=qymh
鸟=qyn
鹱=qync
袅=qyne
岛=qynm
枭=qyns
凫=qynw
鸵=qynx
灸=qyo
钫=qyt
孵=qytb
镞=qytd
卵=qyty
镑=qyu
镝=qyud
留=qyv
锒=qyve
鹠=qyvg
贸=qyvm
遛=qyvp
铰=qyw
钪=qywn
铉=qyxy
的=r
找=ra
拭=raa
皂=rab
撕=rad
揕=radn
撒=rae
扛=rag
措=raj
摸=rajd
揠=rajv
描=ral
拒=ran
拣=ranw
捞=rap
抠=rar
挠=rat
搭=raw
搽=raws
拱=rawy
报=rb
揶=rbbh
摄=rbcc
拯=rbi
凶=rbk
拙=rbm
扔=rbt
把=rc
掇=rcc
搡=rccs
㧐=rccy
掺=rcd
捅=rce
择=rcg
反=rci
抬=rck
抒=rcnh
揉=rcns
返=rcp
挨=rct
摊=rcw
瓜=rcy
搔=rcyj
瓞=rcyw
振=rd
扼=rdb
拔=rdc
郄=rdcb
肴=rde
拜=rdfh
捺=rdfi
皋=rdfj
挎=rdfn
翱=rdfn
拓=rdg
撼=rdgn
揳=rdhd
抔=rdhy
掩=rdj
希=rdm
郗=rdmb
颀=rdmy
瓻=rdmy
扰=rdn
挞=rdp
掎=rdsk
撩=rdu
撅=rduw
捧=rdw
揍=rdwd
摏=rdwe
拢=rdx
摇=re
捋=refy
援=reg
拥=reh
搜=rehc
皭=relf
授=rep
质=rf
技=rfc
持=rff
挂=rffg
摴=rffn
盾=rfh
扞=rfh
遁=rfhp
擀=rfjf
拮=rfk
撷=rfkm
擂=rfl
抟=rfny
挝=rfp
抚=rfq
拷=rft
扶=rfw
撵=rfwl
攉=rfwy
后=rg
邱=rgb
扽=rgbn
卮=rgbv
捯=rgcj
丘=rgd
掭=rgdn
搏=rge
捕=rgey
皇=rgf
郈=rgkb
攮=rgke
垕=rgkf
捂=rgkg
逅=rgkp
岳=rgm
遑=rgp
抹=rgs
乒=rgt
挟=rgu
抨=rguf
捷=rgv
兵=rgw
乓=rgy
年=rh
掳=rha
䴘=rhag
摅=rhan
虒=rhaw
卸=rhb
披=rhc
排=rhd
看=rhf
扯=rhg
拤=rhgh
攫=rhh
掉=rhj
拈=rhk
扑=rhy
爬=rhyc
爪=rhyi
朱=ri
㧟=rian
邾=ribh
捎=rie
㿠=rigq
搅=rip
撑=ripr
抄=rit
泉=riu
挡=riv
提=rj
撮=rjb
捏=rjf
捍=rjfh
担=rjg
刈=rjh
抻=rjhh
揭=rjq
揽=rjt
拽=rjx
损=rk
揖=rkb
挹=rkc
拐=rke
捐=rkeg
捌=rkej
扣=rkg
捉=rkh
操=rkk
摆=rl
摁=rld
舞=rlg
擐=rlge
掴=rlgy
押=rlh
斶=rlqj
捆=rls
撂=rlt
摞=rlx
制=rm
罐=rma
缸=rmag
揣=rmd
抽=rmg
罅=rmhf
帛=rmhj
掣=rmhr
缶=rmk
撄=rmmv
缺=rmn
皑=rmnn
摧=rmw
气=rn
抿=rna
搌=rnae
掘=rnbm
氖=rnbr
撖=rnbt
氢=rnc
据=rnd
氪=rndq
握=rng
挪=rngb
氰=rnge
氩=rngg
扭=rnh
氘=rnjj
氲=rnjl
氚=rnkj
氤=rnl
氙=rnm
扎=rnn
癿=rnn
撰=rnnw
氮=rnoo
氨=rnp
所=rnr
扬=rnrt
拨=rnt
氕=rntr
氡=rntu
氧=rnu
摒=rnua
氯=rnv
氛=rnw
抉=rnwy
擢=rnwy
氟=rnx
拟=rny
氦=rnyw
扩=ro
摭=roao
掂=roh
掞=rooy
搂=rov
搪=rovk
擞=rovt
近=rp
迫=rpd
皖=rpf
挥=rpl
摈=rpr
拧=rps
挓=rpta
按=rpv
控=rpw
撺=rpwh
擦=rpwi
挖=rpwn
探=rpws
换=rq
抵=rqa
扺=rqan
抑=rqb
鬼=rqc
魑=rqcc
魈=rqce
魁=rqcf
魅=rqci
魍=rqcn
魉=rqcw
魃=rqcy
魆=rqcy
魋=rqcy
掐=rqe
撸=rqgj
挑=rqi
挽=rqk
拘=rqkg
搀=rqku
抱=rqn
兜=rqnq
掬=rqo
揿=rqqw
掏=rqr
挣=rqv
欣=rqw
捣=rqym
折=rr
扳=rrc
皈=rrcy
皞=rrdf
拍=rrg
搋=rrhw
抓=rrhy
蜇=rrj
晢=rrjf
哲=rrk
踅=rrkh
逝=rrp
掀=rrq
魄=rrqc
白=rrr
皛=rrrf
捭=rrt
爻=rru
拆=rry
誓=rryf
皦=rryt
打=rs
弑=rsa
摽=rsfi
刹=rsj
揸=rsjg
杀=rsu
手=rt
托=rta
拖=rtb
括=rtd
搬=rte
插=rtf
郫=rtfb
捶=rtfg
鹎=rtfg
扦=rtfh
卑=rtfj
皓=rtfk
攒=rtfm
撬=rtfn
挺=rtfp
攥=rth
拃=rthf
擤=rthj
播=rto
皤=rtol
揪=rtoy
斤=rtt
乂=rty
拉=ru
拼=rua
搠=rube
拦=rud
掷=rudb
抖=ruf
搓=ruga
拌=rugh
撞=ruj
掊=rukg
掸=rul
撇=rum
扪=run
撙=rusf
搁=rut
接=ruv
搛=ruvo
热=rv
抛=rve
挦=rvfy
扫=rvg
招=rvk
殷=rvn
拶=rvqy
捃=rvtk
势=rvy
垫=rvyf
鸷=rvyg
絷=rvyi
蛰=rvyj
贽=rvym
挚=rvyr
执=rvyy
失=rw
抢=rwb
投=rwc
拊=rwfy
拾=rwg
揆=rwgd
拴=rwgg
捡=rwgg
揄=rwgj
迭=rwp
扮=rwv
掰=rwvr
挫=rww
抡=rwx
扒=rwy
携=rwyb
擒=rwyc
拎=rwyc
推=rwyg
捻=rwyn
指=rx
拗=rxe
掼=rxfm
掾=rxge
拂=rxjh
搦=rxuu
批=rxx
揩=rxxr
拇=rxy
护=ry
撤=ryc
拄=ryg
抃=ryhy
斥=ryi
挤=ryj
搞=ryk
攘=ryke
掠=ryki
擅=ryl
掮=ryne
捩=ryny
摛=ryrc
邀=ryt
敫=ryty
㧑=ryty
摘=ryu
擿=ryup
搒=ryuy
抗=ryw
捽=rywf
皎=rywr
掖=rywy
摔=ryx
搐=ryxl
要=s
模=sa
械=saa
栻=saay
栉=sab
棋=sad
椹=sadn
柑=saf
杠=sag
框=sagg
榧=sahd
栋=sai
欂=saif
棤=sajg
槿=sakg
棫=sakg
横=sam
柜=san
楪=sans
檬=sap
柩=saqy
枢=sar
桡=satq
杙=sayy
李=sb
椰=sbb
楹=sbcl
椭=sbd
极=sby
权=sc
桶=sce
树=scf
柽=scfg
杩=scgg
杷=scn
杼=scnh
橘=scnk
懋=scnn
楙=scns
梭=scw
杈=scyy
顶=sd
枥=sdet
枯=sdg
柘=sdg
橱=sdgf
杯=sdh
楔=sdhd
槭=sdhy
椅=sds
梆=sdt
梼=sdtf
橑=sdui
橛=sduw
棒=sdw
椿=sdwj
榛=sdwt
栊=sdxy
杖=sdy
杕=sdy
棚=se
桴=sebg
桕=seg
枷=sek
杉=set
朸=set
村=sf
鄄=sfbh
枝=sfc
㭕=sfcy
桂=sff
樗=sffn
杜=sfg
甄=sfgy
杆=sfh
植=sfhg
樾=sfhy
票=sfi
剽=sfij
飘=sfir
柰=sfiu
标=sfiy
瓢=sfiy
桔=sfk
檑=sflg
楠=sfm
椟=sfnd
梽=sfny
桲=sfpb
歅=sfqw
材=sft
楮=sftj
榰=sftj
栲=sftn
栳=sftx
樯=sfuk
棱=sfw
栈=sfx
本=sg
醋=sga
酣=sgaf
醛=sgag
枅=sgah
酏=sgbn
酸=sgc
桎=sgcf
酉=sgd
醐=sgde
酤=sgdg
醢=sgdl
酞=sgdy
酹=sge
榑=sgef
椓=sgey
酵=sgf
酝=sgfc
酐=sgfh
酎=sgfy
枉=sgg
酽=sggd
酾=sggy
酺=sggy
丁=sgh
醵=sghe
西=sghg
醒=sgj
桓=sgjg
醍=sgjh
橞=sgjn
梗=sgjr
醌=sgjx
梧=sgk
酲=sgkg
楝=sgli
槽=sgm
酮=sgmk
醴=sgmu
柄=sgmw
配=sgn
醪=sgne
醑=sgne
朽=sgnn
酦=sgny
醚=sgo
桠=sgog
醾=sgoo
醭=sgow
梾=sgoy
酡=sgpx
酌=sgq
酩=sgqk
杌=sgqn
酗=sgr
酊=sgs
酷=sgt
酢=sgtf
酪=sgtk
醺=sgto
酰=sgtq
酶=sgtx
酥=sgty
枰=sguf
醅=sguk
酚=sgw
醮=sgwo
酴=sgws
酯=sgxj
醉=sgy
醇=sgyb
醨=sgyc
酿=sgye
酬=sgyh
醯=sgyl
相=sh
椒=shgc
棹=shjf
桢=shmy
想=shn
栌=shnt
朴=shy
档=si
梢=sie
榉=sigg
桄=sigq
桫=siit
樘=sipf
杪=sitt
查=sj
杳=sjf
覃=sjfj
榅=sjlg
榻=sjn
棵=sjs
槛=sjt
榄=sjtq
棍=sjx
可=sk
楫=skb
杏=skf
桯=skgg
枵=skgn
梠=skkg
柷=skqn
哥=sks
歌=sksw
枳=skwy
楞=sl
柙=slh
楒=slny
梿=slpy
椤=slqy
贾=sm
椆=smfk
柚=smg
桐=smgk
栅=smm
樱=smmv
桤=smnn
枧=smqn
㭎=smry
梣=smwn
枘=smwy
杨=sn
橄=snbt
椐=sndg
栩=sng
楣=snh
杻=snhf
樨=sni
榍=snie
札=snn
杞=snn
杰=so
桩=sof
棪=sooy
粟=sou
楼=sov
枕=sp
迺=spd
棕=spf
楦=spgg
棺=sph
椀=spqb
槟=sprw
柠=sps
桉=spv
榷=spw
榨=spwf
檫=spwi
榕=spwk
柁=spxn
构=sq
柢=sqay
桅=sqd
檐=sqdy
槲=sqef
檞=sqeg
桷=sqeh
橹=sqgj
桃=sqi
栒=sqjg
橡=sqk
枸=sqkg
枹=sqnn
柳=sqt
榴=sqy
杓=sqyy
析=sr
板=src
槔=srdf
楯=srfh
柏=srg
栀=srgb
株=sri
棉=srm
槐=srq
櫆=srqf
攀=srr
樊=srrd
皙=srrf
椑=srtf
檄=sry
柝=sryy
林=ss
郴=ssb
彬=sse
禁=ssf
栖=ssg
槱=ssgo
楂=ssjg
柯=ssk
榃=sslf
槚=ssmy
楚=ssn
焚=sso
麓=ssox
梦=ssq
森=sss
木=ssss
栗=ssu
婪=ssv
棽=sswn
棼=sswv
梵=sswy
格=st
枨=stay
桥=std
栝=stdg
橇=stf
棰=stfg
杵=stfh
杄=stfh
梏=stfk
梃=stfp
桁=stgs
柞=sth
梴=sthp
榭=stm
栴=stmy
栎=stni
楸=sto
㰀=stqi
覆=stt
柊=stuy
梅=stx
枚=sty
样=su
栟=suah
栏=sud
棬=sudb
梓=sufh
槎=suga
柈=sugh
樟=suj
橦=sujf
棓=sukg
榈=sukk
棁=sukq
椪=suog
樽=susf
榇=susy
梯=sux
根=sv
概=svc
楗=svgp
棣=sviy
柖=svkg
棂=svoy
机=sw
枪=swb
松=swc
椴=swdc
桧=swfc
检=swg
栓=swgg
榆=swgj
枍=swgn
楩=swgr
梌=swgs
橙=swgu
槌=swnp
枫=swr
枞=swwy
桦=swx
椎=swy
朳=swy
槜=swyb
檎=swyc
柃=swyc
榫=swyf
樵=swyo
楷=sx
椽=sxg
橼=sxxe
枇=sxxn
术=sy
梳=syc
槠=syfj
柱=syg
槁=syk
椁=sykb
榱=syke
椋=syki
檀=syl
檩=syli
柿=sym
核=syn
栐=syni
杧=synn
述=syp
枋=syt
椸=sytb
榜=syu
榔=syv
桹=syve
校=syw
杭=sywn
和=t
长=ta
筇=tabj
箕=tad
簸=tadc
箬=tadk
筐=tag
箧=tagd
篚=tahd
逄=tahp
升=tak
簕=take
笸=takf
簧=tam
篝=tamf
秬=tang
簪=taqj
彻=tavt
筑=taw
筮=taww
秀=tb
季=tbf
透=tbp
迤=tbpv
笈=tbyu
么=tc
径=tca
笆=tcb
䅟=tcde
笃=tcg
笞=tck
私=tcy
知=td
甜=tda
矩=tdan
舌=tdd
牯=tdg
舔=tdgn
短=tdgu
箴=tdgy
逢=tdh
夭=tdi
籍=tdij
乔=tdj
刮=tdjh
智=tdk
岙=tdmj
乱=tdn
稽=tdnj
嵇=tdnm
牻=tdny
适=tdp
舐=tdq
鸹=tdqg
犄=tdsk
徛=tdsk
敌=tdt
筹=tdtf
矫=tdtj
憩=tdtn
矮=tdtv
矢=tdu
辞=tduf
簝=tdui
矰=tduj
雉=tdw
矬=tdwf
笼=tdx
矧=tdxh
务=te
艨=teae
稃=tebg
艋=tebl
舥=tecn
稻=tee
艘=teec
筋=teer
租=teg
徂=tegg
艚=tegj
甪=tehk
舻=tehn
舟=tei
艄=teie
笳=tek
舯=tekh
盘=tel
舰=tem
舳=temg
舢=temh
艉=tenn
舵=tep
笾=tepu
鸼=teqg
舶=terg
艎=terg
徭=term
舾=tesg
舸=tesk
艇=tet
舴=tetf
艟=teuf
艏=teuh
舠=tevt
般=tew
舱=tewb
舲=tewc
磐=tewd
船=tewk
槃=tews
艅=tews
舭=texx
航=tey
舣=teyr
舫=teyt
舷=teyx
等=tf
垂=tfa
丢=tfc
壬=tfd
歃=tfew
竺=tff
筀=tfff
街=tffs
特=tffy
待=tffy
牡=tfg
衎=tfgs
秆=tfh
稙=tfhg
衠=tfhs
稹=tfhw
徒=tfhy
午=tfj
竿=tfj
千=tfk
郜=tfkb
靠=tfkd
告=tfkf
秸=tfkg
鹄=tfkg
造=tfkp
德=tfl
毛=tfn
犊=tfnd
毪=tfng
氆=tfnj
氇=tfnj
毡=tfnk
毳=tfnn
毯=tfno
毽=tfnp
廷=tfp
迁=tfpk
迕=tfpk
颋=tfpm
先=tfq
酂=tfqb
赞=tfqm
选=tfqp
筠=tfqu
箸=tftj
乖=tfu
穑=tfuk
稑=tfwf
笺=tfx
生=tg
笄=tgaj
箐=tgef
簠=tgel
竽=tgf
征=tgh
眚=tghf
惩=tghn
重=tgj
穗=tgjn
筻=tgjr
牛=tgk
牾=tgkg
籁=tgkm
衙=tgks
簌=tgkw
熏=tgl
甥=tgle
策=tgm
箦=tgmu
徕=tgoy
行=tgs
鸻=tgsg
秣=tgsy
犇=tgtg
甡=tgtg
秤=tgu
秉=tgv
处=th
算=tha
彼=thc
自=thd
篡=thdc
徘=thdd
纂=thdi
臭=thdy
怎=thf
乍=thff
迮=thfp
片=thg
版=thgc
牍=thgd
牌=thgf
牒=thgs
牖=thgy
徙=thh
衢=thhs
昝=thj
咎=thk
鼻=thl
齉=thle
鼾=thlf
齇=thlg
劓=thlj
齁=thlk
鼽=thlv
息=thn
延=thp
臬=thsu
竹=tht
犋=thwy
秒=ti
稍=tie
筲=tief
簿=tig
愆=tign
衍=tigs
徜=tim
箔=tir
筜=tivf
得=tj
香=tjf
馞=tjfb
笪=tjgf
筛=tjgh
利=tjh
馧=tjjl
馝=tjnt
梨=tjs
稞=tjsy
复=tjt
犁=tjtg
篮=tjtl
馥=tjtt
各=tk
程=tkgg
种=tkh
篑=tkhm
筥=tkkf
稆=tkkg
禹=tkm
鄅=tkmb
筼=tkmu
积=tkw
雒=tkwy
备=tl
血=tld
衃=tldh
篾=tldy
盉=tlf
睾=tlff
箅=tlgj
徊=tlk
惫=tln
衄=tlnf
粤=tlo
箩=tlq
囱=tlqi
囟=tlri
衅=tlu
稷=tlw
向=tm
身=tmd
射=tmdf
躺=tmdk
躯=tmdr
躲=tmds
躬=tmdx
秧=tmdy
笛=tmf
稠=tmfk
微=tmg
筒=tmgk
徽=tmgt
徵=tmgt
币=tmh
奥=tmo
秽=tmq
笕=tmqb
乐=tn
乞=tnb
笥=tngk
筷=tnn
迄=tnp
秘=tnt
秋=to
释=toc
穙=togw
翻=tol
鄱=tolb
番=tolf
釉=tom
愁=ton
簖=tonr
悉=tonu
簏=tonx
鹙=toqg
篓=tov
管=tp
秾=tpey
筦=tpfq
稼=tpg
箢=tpqb
乏=tpu
箜=tpwa
物=tq
衡=tqd
篯=tqfy
衔=tqg
称=tqi
徇=tqj
笱=tqkf
移=tqq
笏=tqrr
黎=tqt
黧=tqto
稳=tqv
筝=tqvh
稀=tr
箍=tra
筢=trcb
箨=trcg
循=trf
徨=trg
篁=trgf
御=trh
篪=trhw
笊=trhy
穆=tri
筘=trkf
籀=trql
篼=trqq
稗=trt
秩=trw
鹅=trxg
徼=try
条=ts
牺=tsg
笨=tsgf
箱=tsh
簟=tsjf
篥=tssu
箖=tssu
秫=tsyy
笔=tt
笑=ttd
篷=ttdp
牿=ttfk
筶=ttfk
牦=ttfn
簉=ttfp
筅=ttfq
牲=ttg
笙=ttgf
笮=tthf
簰=tthf
筵=tthp
篦=ttlx
秭=ttnt
笫=ttnt
簃=ttqq
禾=ttt
彳=ttth
牧=tty
科=tu
箭=tue
穟=tuep
笠=tuf
乎=tufk
徉=tugh
简=tuj
穜=tujf
螽=tujj
税=tuk
箪=tulj
冬=tuu
乘=tux
剩=tuxj
很=tv
笯=tvcu
簋=tvel
委=tvf
律=tvg
犍=tvgp
箫=tvij
箓=tviu
笤=tvkf
逶=tvp
魏=tvr
笋=tvt
答=tw
筏=twa
秃=twb
役=twc
颓=twd
符=twf
穄=twfi
徐=twg
籥=twga
筌=twgf
签=twgg
劄=twgj
稌=twgs
筱=twht
黏=twi
黍=twiu
篌=twnd
稚=twy
稔=twyn
第=tx
胤=txen
篆=txg
系=txi
牝=txn
繁=txt
鳘=txtg
敏=txty
每=txu
筚=txxf
秕=txxn
毓=txyk
入=ty
往=tyg
汆=tyiu
稿=tyk
穰=tyke
篙=tykk
犒=tykk
篇=tyn
犏=tyna
牤=tynn
籴=tyo
篱=tyr
彷=tyt
牥=tyt
簇=tytd
稂=tyve
筤=tyve
衒=tyxs
产=u
并=ua
凘=uadr
疳=uafd
瓶=uag
冮=uag
疟=uagd
冻=uai
瘼=uajd
阈=uakg
癀=uamw
迸=uap
痨=uape
瘩=uaw
闻=ub
疗=ubk
疖=ubk
瘾=ubq
塑=ubt
朔=ubte
癃=ubtg
逆=ubtp
槊=ubts
痛=uc
痉=uca
瘆=ucde
冯=ucg
闯=ucgd
冶=uck
疤=ucv
瘫=ucw
竣=ucwt
瘙=ucyj
头=ud
卷=udb
郑=udbh
闳=udci
竑=udcy
闫=udd
疬=udee
兰=udf
减=udg
豢=udge
辣=udgi
眷=udh
痞=udhk
瘛=udhn
阉=udj
疣=udn
送=udp
闼=udpi
鲞=udqg
拳=udr
瓣=udrf
桊=udsu
关=udu
券=udv
凑=udw
辫=udx
状=udy
辩=udyf
辨=udyf
誊=udyf
前=ue
疽=ueg
瘦=ueh
痈=uehk
翦=uejn
煎=uejo
剪=uejv
瘸=uek
痂=uekd
遂=uep
阌=uepc
阋=ueqv
毅=uew
瘐=uewi
斗=uf
阖=ufc
闺=uff
痔=uffi
壮=ufg
癫=ufh
阗=ufhw
辛=ufj
癗=ufld
闱=ufnh
痣=ufni
羌=ufq
闭=uft
阇=uftj
养=ufw
凌=ufwt
装=ufy
着=ug
差=uga
羟=ugca
痓=ugcf
羓=ugcn
羧=ugct
闰=ugd
闩=ugd
羱=ugdi
美=ugdu
靖=uge
瘃=ugey
症=ugh
羊=ugj
判=ugjh
羯=ugjn
半=ugk
痦=ugkd
竦=ugki
瘌=ugkj
癞=ugkm
痘=ugku
盖=ugl
阑=ugli
病=ugm
羰=ugmo
羞=ugn
翔=ugng
恙=ugnu
羹=ugo
羔=ugou
冽=ugq
疠=ugqe
鲝=ugqg
羑=ugqy
羝=ugqy
叛=ugr
羲=ugty
善=ugu
羡=ugu
鄯=ugub
瘗=uguf
姜=ugv
凄=ugvv
羚=ugw
羖=ugwc
冱=ugxg
痍=ugxw
癍=ugyg
羕=ugyi
站=uh
疲=uhc
痱=uhdd
阒=uhdy
癯=uhhy
丫=uhk
疵=uhx
冰=ui
痧=uiit
阔=uit
瘠=uiwe
间=uj
音=ujf
鄣=ujfb
彰=ujfe
童=ujff
章=ujfj
赣=ujfm
戆=ujfn
疸=ujgd
闽=uji
阊=ujjd
瘟=ujl
意=ujn
阘=ujnd
竟=ujq
竭=ujqn
韵=ujqu
歆=ujqw
韶=ujv
问=uk
部=ukb
瓿=ukgy
冲=ukh
剖=ukj
癌=ukk
闾=ukkd
总=ukn
况=ukq
竞=ukqb
兑=ukqb
单=ul
郸=ulb
痼=uld
兽=ulg
痹=ulgj
鄫=uljb
曾=uljf
䎖=uljn
甑=uljy
闸=ulk
冁=ulne
阃=ulsi
瘰=ulxi
端=um
凋=umf
弊=umi
鳖=umig
瞥=umih
蹩=umih
憋=umin
敝=umit
疝=umk
瘿=ummv
闿=umnv
决=un
癜=unac
阚=unbt
翊=ung
瘕=unhc
闷=uni
癖=unk
疡=unr
瘳=unwe
普=uo
疢=uoi
痰=uoo
瘘=uov
次=uq
阍=uqaj
奖=uqd
阎=uqe
将=uqf
癣=uqg
浆=uqi
阄=uqjn
竘=uqkg
痪=uqm
疱=uqnv
酱=uqs
桨=uqsu
净=uqv
竫=uqvh
资=uqw
咨=uqwk
盗=uqwl
恣=uqwn
粢=uqwo
姿=uqwv
瓷=uqwy
瘤=uqy
疚=uqyi
亲=us
瘭=usfi
尊=usg
奠=usgd
酋=usgf
遵=usgp
遒=usgp
猷=usgy
闲=usi
疔=usk
疴=uskd
鹇=usqg
新=usr
凓=ussy
凇=uswc
道=ut
疾=utd
痴=utdk
瘢=utec
彦=utee
颜=utem
冼=utfq
首=uth
痄=uthf
馘=uthg
夔=utht
瘪=uthx
痢=utj
阁=utk
疙=utn
疼=utu
痿=utvd
立=uu
阙=uubw
痒=uug
瘥=uuga
瘴=uuj
癔=uujn
阅=uuk
阐=uul
瘅=uulk
痫=uusi
兼=uv
痕=uve
妾=uvf
妆=uvg
歉=uvo
鹣=uvog
准=uw
阀=uwa
疮=uwb
疫=uwc
疹=uwe
瘵=uwfi
痊=uwg
阕=uwgd
闪=uwi
疥=uwj
益=uwl
鹢=uwlg
蠲=uwlj
瘊=uwnd
疯=uwr
飒=uwry
痤=uwwf
疭=uwwi
冷=uwy
北=ux
邶=uxbh
背=uxe
弟=uxh
鹈=uxhg
剃=uxhj
递=uxhp
冀=uxl
凝=uxt
兹=uxx
孳=uxxb
鹚=uxxg
慈=uxxn
门=uy
訚=uyd
疰=uygd
闵=uyi
凉=uyk
凛=uyl
闹=uym
阂=uyn
阆=uyve
瘁=uyw
阏=uywu
瘀=uywu
闶=uywv
痃=uyxi
媒=va
婼=vadk
娀=vadt
姬=vah
嫫=vajd
嬿=vako
媾=vam
媖=vamd
妪=var
嫕=vatn
娆=vatq
好=vb
娵=vbcy
媸=vbhj
她=vbn
婀=vbsk
奶=vbt
即=vc
既=vca
暨=vcag
孥=vcbf
堲=vcbf
驽=vccg
砮=vcdf
努=vce
㛚=vceh
妈=vcg
始=vck
帑=vcmh
胬=vcmw
怒=vcn
妤=vcnh
弩=vcx
奴=vcy
姑=vd
妭=vdcy
娠=vdf
姱=vdfn
媆=vdmd
嫄=vdri
婍=vdsk
嫽=vdui
退=ve
垦=vef
姐=veg
媛=vegc
嫂=veh
艮=vei
恳=ven
嫒=vepc
媱=verm
寻=vf
彟=vfac
妓=vfc
妘=vfcy
嬬=vfdj
娃=vff
奸=vfh
妹=vfi
嬉=vfk
姞=vfkg
婻=vfmf
妩=vfq
妧=vfqn
孀=vfsh
姥=vft
婞=vfuf
嫱=vfuk
建=vg
妍=vga
婊=vge
婧=vgeg
嫣=vgh
姮=vgjg
聿=vgk
嫩=vgkt
婳=vglb
娅=vgo
婕=vgvh
姨=vgx
嫭=vhaf
虓=vhaw
婌=vhgc
录=vi
隶=vii
肃=vij
鹔=vijg
剥=vijh
逮=vip
嫦=viph
逯=vipi
妙=vit
旭=vj
旮=vjf
娌=vjfg
妲=vjgg
媞=vjgh
娼=vjj
嫚=vjlc
媪=vjlg
巢=vjs
剿=vjsj
婫=vjxx
如=vk
邵=vkb
邕=vkcb
娟=vke
劭=vket
召=vkf
娱=vkgd
娲=vkmw
恕=vkn
迢=vkp
絮=vkx
姻=vl
甾=vlf
嬛=vlge
邋=vlrp
嫘=vlxi
姗=vm
婤=vmfk
妯=vmg
娉=vmgn
刀=vn
娜=vng
婿=vnh
妞=vnhf
媚=vnhg
妃=vnn
娓=vntn
嫪=vnwe
嬥=vnwy
妮=vnx
姒=vnyw
灵=vo
嬷=vosc
嫁=vp
婠=vphn
婶=vpj
帚=vpm
婉=vpq
嫔=vprw
姹=vpta
巡=vpv
婚=vq
姽=vqdb
姚=vqi
娩=vqk
鸠=vqy
妁=vqyy
婢=vr
媓=vrgg
姤=vrgk
姝=vriy
杂=vs
嫖=vsf
九=vt
娇=vtd
妖=vtdy
尹=vte
妊=vtf
姓=vtg
媳=vth
群=vtk
郡=vtkb
君=vtkf
媲=vtl
姊=vtnt
娥=vtr
嫌=vu
姘=vuah
婘=vudb
媄=vugd
嫜=vujf
婵=vul
娴=vus
嫉=vut
馗=vuth
娣=vux
妇=vv
女=vvv
妗=vw
姶=vwgk
㛹=vwgr
孅=vwwg
姈=vwyc
姆=vx
妣=vxxn
娘=vy
訄=vyd
刃=vyi
丸=vyi
婷=vyk
嬗=vylg
忍=vyn
妒=vynt
妨=vyt
妫=vyty
嫡=vyu
媂=vyuh
姣=vyw
人=w
代=wa
偌=wadk
偡=wadn
仝=waf
垡=waff
伢=waht
借=waj
偃=wajv
儆=waq
僭=waqj
伛=wary
侥=wat
供=waw
伐=way
袋=waye
垈=wayf
牮=wayg
贷=waym
岱=waym
黛=wayo
他=wb
戗=wbay
仓=wbb
倻=wbbh
仔=wbg
佴=wbg
创=wbj
鸧=wbqg
仍=wbt
伋=wbyy
公=wc
颂=wcd
俑=wce
瓮=wcg
凤=wci
佁=wckg
翁=wcn
鹟=wcng
俟=wct
侔=wctg
殳=wcu
俊=wcw
傩=wcwy
仅=wcy
做=wd
佐=wda
侑=wdeg
倴=wdfa
傉=wdff
侉=wdfn
估=wdg
仨=wdg
偰=wdhd
伾=wdhg
俺=wdj
佰=wdjg
佑=wdk
偭=wdmd
优=wdn
倚=wds
俦=wdtf
僚=wdu
段=wdw
俸=wdwg
傣=wdwi
伏=wdy
仗=wdyy
佣=we
俘=web
伽=wek
偁=wemf
倪=weq
仂=wet
傒=wexd
会=wf
偾=wfam
郐=wfcb
刽=wfcj
伎=wfcy
儒=wfd
佳=wff
侍=wffy
仁=wfg
仕=wfg
什=wfh
值=wfhg
祭=wfi
畲=wfil
佘=wfiu
舍=wfk
佶=wfkg
舒=wfkh
僖=wfkk
传=wfn
伟=wfnh
佬=wft
佞=wfvg
付=wfy
全=wg
倒=wgc
侄=wgcf
癸=wgd
戣=wgda
傅=wge
鄃=wgeb
倩=wgeg
俞=wgej
愈=wgen
毹=wgen
逾=wgep
觎=wgeq
俵=wgey
伍=wgg
剑=wgi
佥=wgig
敛=wgit
俅=wgiy
便=wgj
合=wgk
龠=wgka
弇=wgka
命=wgkb
郃=wgkb
鸽=wgkg
盒=wgkl
颌=wgkm
翕=wgkn
使=wgkr
拿=wgkr
龢=wgkt
登=wgku
凳=wgkw
歙=wgkw
龛=wgky
僵=wgl
俩=wgm
债=wgmy
俪=wgmy
兮=wgnb
侴=wgnj
佤=wgny
俨=wgo
俫=wgoy
例=wgq
夙=wgqi
傲=wgqt
余=wgs
叙=wgsc
斜=wgsf
㙦=wgsf
畬=wgsl
悆=wgsn
途=wgsp
侠=wgu
傃=wgxi
个=wh
俳=whdd
企=whf
俶=whgc
倬=whjf
侦=whm
候=whn
修=wht
脩=whte
悠=whtn
翛=whtn
攸=whty
倏=whty
俱=whw
仆=why
偿=wi
俏=wie
倘=wim
傥=wipq
介=wj
俚=wjf
但=wjg
伸=wjh
倡=wjjg
偶=wjm
偈=wjqn
倮=wjsy
保=wk
俣=wkgd
促=wkh
仲=wkhh
侣=wkk
侃=wkkn
堡=wksf
煲=wkso
佃=wl
偎=wlge
儇=wlge
儡=wll
偲=wlny
仙=wm
倜=wmf
侗=wmg
俜=wmgn
侧=wmj
伣=wmqn
催=wmw
假=wn
倔=wnb
倨=wndg
伺=wng
偓=wngf
僻=wnk
亿=wnn
阜=wnnf
追=wnnp
僎=wnnw
侯=wnt
佖=wntt
僇=wnwe
伲=wnxn
似=wny
伈=wny
伙=wo
儦=wono
倓=wooy
侂=wota
偻=wovg
俯=wow
伫=wp
侬=wpe
倧=wpfi
倌=wphn
傧=wprw
侘=wpta
倥=wpwa
傕=wpwy
佗=wpxn
你=wq
低=wqa
仰=wqb
儋=wqdy
您=wqin
佻=wqiy
像=wqk
佝=wqkg
儳=wqky
侈=wqq
偬=wqrn
㑇=wqvg
风=wr
爷=wrb
爸=wrc
俙=wrdh
飕=wrec
釜=wrf
伯=wrg
凰=wrgd
飐=wrhk
飓=wrhw
侏=wriy
飔=wrln
飏=wrnr
爹=wrq
傀=wrqc
飗=wrql
飑=wrqn
斧=wrr
俾=wrt
父=wru
佚=wrwy
体=ws
仃=wsh
剁=wsj
何=wsk
僳=wsoy
鸺=wsqg
傈=wss
朵=wsu
休=wsy
八=wt
伥=wtay
仫=wtcy
侨=wtd
佸=wtdg
伤=wte
任=wtf
倕=wtfg
仟=wtfh
仵=wtfh
赁=wtfm
恁=wtfn
侹=wtfp
侁=wtfq
凭=wtfw
件=wtg
作=wth
俐=wtj
傻=wtl
几=wtn
仡=wtnn
俄=wtr
佟=wtuy
倭=wtvg
侮=wtx
位=wu
倦=wud
伞=wuf
伴=wugh
佯=wugh
僮=wujf
倍=wuk
僧=wul
们=wun
佽=wuqw
僔=wusf
分=wv
邠=wvbh
颁=wvd
坌=wvff
健=wvg
盆=wvl
贫=wvm
岔=wvmj
仇=wvn
忿=wvnu
侵=wvp
伊=wvt
攽=wvty
仞=wvyy
从=ww
耸=wwb
伧=wwbn
俎=wweg
佾=wweg
坐=wwf
侩=wwfc
傺=wwfi
丛=wwg
俭=wwgg
佺=wwgg
佩=wwgh
偷=wwgj
价=wwj
谷=wwk
郤=wwkb
鹆=wwkg
欲=wwkw
谼=wwkw
仉=wwn
怂=wwnu
份=wwv
众=www
俗=wwwk
伦=wwx
伶=wwyc
僬=wwyo
化=wx
仑=wxb
倾=wxd
华=wxf
佛=wxj
货=wxm
偕=wxx
仳=wxxn
信=wy
隽=wybr
令=wyc
邻=wycb
鸰=wycg
领=wycm
翎=wycn
瓴=wycy
依=wye
储=wyf
隼=wyfj
隹=wyg
住=wygg
凡=wyi
侪=wyjh
停=wyk
儴=wyke
售=wykf
倞=wyki
僦=wyky
今=wyn
偏=wyna
衾=wyne
含=wynk
盦=wynl
贪=wynm
颔=wynm
念=wynn
焦=wyo
鹪=wyog
劁=wyoj
㑊=wyoy
仪=wyr
禽=wyrc
集=wys
仿=wyt
伪=wyty
傍=wyu
食=wyv
俍=wyve
犨=wywg
伉=wywn
佼=wywr
伭=wyxy
雠=wyyy
经=x
红=xa
绒=xad
绀=xafg
缂=xakf
练=xan
绁=xann
绕=xat
级=xb
弭=xbg
弢=xbhc
绌=xbm
弛=xbn
缀=xcc
绎=xcg
绐=xckg
纾=xcnh
弘=xcy
顷=xd
绂=xdcy
纮=xdcy
毋=xdd
缛=xdff
绔=xdfn
缄=xdg
弼=xdj
缅=xdmd
绮=xds
绑=xdt
缭=xdu
组=xe
绷=xee
弸=xeeg
缓=xegc
绶=xep
幼=xet
绥=xev
线=xf
纭=xfcy
毌=xfd
疆=xfg
缜=xfh
结=xfk
缬=xfkm
贯=xfm
续=xfn
纬=xfnh
鸨=xfqg
绪=xft
绫=xfwt
纣=xfy
纯=xg
绖=xgcf
缚=xge
蠡=xgej
彖=xgeu
纡=xgfh
绠=xgjr
缰=xglg
绩=xgm
彝=xgo
缙=xgoj
彘=xgtx
引=xh
绯=xhd
缈=xhi
绰=xhj
纱=xi
颍=xidm
绡=xieg
绱=ximk
费=xj
旨=xjf
缇=xjgh
绅=xjh
弗=xjk
缦=xjlc
缊=xjlg
艴=xjqc
缆=xjt
绲=xjxx
强=xk
缉=xkb
绢=xke
缱=xkhp
绳=xkj
犟=xkjg
缲=xkks
织=xkw
细=xl
缳=xlge
缌=xlny
缧=xlxi
纲=xm
绸=xmf
䌹=xmkg
缨=xmm
纳=xmw
纪=xn
缗=xnaj
弓=xng
纠=xnh
纽=xnhf
幻=xnn
母=xnny
缪=xnw
继=xo
颎=xodm
缠=xoj
纩=xot
缕=xov
粥=xox
鬻=xoxh
缩=xp
综=xpf
绽=xpg
纻=xpgg
绾=xphn
缤=xpr
约=xq
纸=xqa
绝=xqc
弥=xqi
绚=xqj
绹=xqrm
绉=xqv
缴=xr
弧=xrc
缐=xriy
绵=xrm
缥=xs
缃=xshg
张=xt
绛=xtah
绣=xtb
疑=xtd
肄=xtdg
颖=xtdm
缝=xtdp
乡=xte
纤=xtf
纴=xtfg
缵=xtfm
绗=xtgs
绺=xthk
络=xtk
匕=xtn
纥=xtnn
绦=xts
终=xtu
飨=xtwe
弱=xu
绻=xudb
绊=xug
缮=xugk
弹=xul
缯=xulj
缣=xuvo
缢=xuwl
绨=xuxt
绿=xv
缫=xvj
绍=xvk
弨=xvkg
缁=xvlg
纫=xvy
纨=xvyy
给=xw
缎=xwd
绘=xwf
缑=xwnd
缒=xwnp
纷=xwv
纵=xww
绤=xwwk
纶=xwx
维=xwy
比=xx
畿=xxal
毕=xxf
坒=xxff
丝=xxg
缘=xxge
鸶=xxgg
毙=xxgx
纼=xxhh
绋=xxjh
毖=xxnt
皆=xxr
纰=xxxn
幺=xxxx
统=xy
缞=xyke
弶=xyki
缟=xykk
编=xyn
缡=xyrc
纺=xyt
缔=xyu
绞=xyw
弦=xyx
纹=xyy
主=y
谋=ya
试=yaa
诫=yaa
诺=yad
谌=yadn
讧=yag
诓=yagg
讶=yah
谟=yaj
谨=yak
谍=yan
讵=yang
谮=yaqj
讴=yary
诬=yaw
谎=yay
诎=yb
诹=ybcy
邡=ybh
充=yc
弃=yca
育=yce
诵=yceh
译=ycg
诒=yck
谲=ycn
袤=ycne
诚=yd
诂=ydg
诔=ydiy
斋=ydm
诙=ydo
衣=ye
裒=yeeu
诅=yeg
谖=yegc
裔=yem
亹=yemg
谣=yer
谀=yew
计=yf
诗=yff
诖=yffg
讦=yfh
赟=yfhm
斌=yfhy
讲=yfj
诘=yfk
谳=yfmy
读=yfn
讳=yfnh
诸=yft
讨=yfy
请=yg
诼=ygey
证=ygh
语=ygk
谏=ygl
评=ygu
让=yh
谑=yha
诐=yhcy
诽=yhd
卞=yhu
讣=yhy
诮=yi
谠=yipq
刘=yj
齑=yjhg
齐=yjj
剂=yjjh
谩=yjl
谒=yjq
课=yjs
裹=yjse
就=yk
郭=ykb
享=ykbf
塾=ykbf
鹑=ykbg
亨=ykbj
亸=ykbl
熟=ykbo
烹=ykbo
敦=ykbt
孰=ykby
裛=ykce
哀=yke
吝=ykf
误=ykg
衰=ykge
训=ykh
衷=ykhe
谴=ykhp
京=yki
勍=ykie
鹫=ykig
襄=ykk
谔=ykkn
瓤=ykky
高=ykm
鄗=ykmb
敲=ykmc
亮=ykp
亳=ykpa
豪=ykpe
膏=ykpe
毫=ykpn
亭=ykps
识=ykw
谓=yl
亩=ylf
颤=ylk
亶=ylkg
鹯=ylkg
禀=ylki
谡=ylwt
市=ym
调=ymf
讪=ymh
诇=ymkg
讷=ymw
记=yn
邙=ynbh
戾=yndy
户=yne
肩=yned
肓=ynef
望=yneg
讯=ynf
诩=yng
词=yngk
盲=ynh
扉=ynhd
谞=ynhe
扂=ynhk
永=yni
昶=ynij
启=ynk
扈=ynkc
赢=ynky
嬴=ynky
羸=ynky
蠃=ynky
遍=ynm
扁=ynma
扃=ynmk
翩=ynmn
氓=ynna
扇=ynnd
忘=ynnu
扊=ynoo
扅=ynqq
刻=ynt
劾=ynte
肇=yntg
綮=ynti
谧=yntl
颏=yntm
棨=ynts
亥=yntw
忞=ynu
戽=ynuf
亡=ynv
妄=ynvf
雇=ynw
谬=ynwe
诀=ynwy
房=yny
扆=ynye
变=yo
弈=yoaj
孪=yob
奕=yodu
蛮=yoj
峦=yom
脔=yomw
恋=yon
谈=yoo
燮=yooc
迹=yop
谜=yopy
銮=yoq
鸾=yoqg
挛=yor
栾=yosu
亦=you
娈=yovf
弯=yox
谊=ype
诨=ypl
诧=ypt
询=yq
诋=yqa
诡=yqd
谵=yqdy
谄=yqe
谗=yqk
诳=yqtg
诌=yqv
诤=yqvh
义=yr
离=yrb
讻=yrbh
诟=yrgk
䜣=yrh
诛=yriy
旆=yrmh
亵=yrv
诉=yry
订=ys
谭=ysj
诃=ysk
放=yt
旗=yta
施=ytb
诱=ytbt
话=ytd
旖=ytdk
旅=yte
膂=ytee
许=ytf
诰=ytfk
诜=ytfq
诞=yth
诈=ythf
谢=ytm
旃=ytmy
旋=ytn
讫=ytnn
旎=ytnx
旐=ytqi
族=ytt
旌=yttg
旄=yttn
旞=ytup
诿=ytv
诲=ytx
州=ytyh
旒=ytyk
说=yu
谫=yuev
详=yug
谰=yugi
斓=yugi
谙=yujg
商=yum
谱=yuo
帝=yup
啻=yupk
遆=yupp
旁=yupy
谚=yut
谦=yuv
谥=yuw
良=yv
朗=yvc
郎=yvcb
塱=yvcf
㮾=yvcs
诏=yvk
讱=yvyy
六=yw
亢=ywb
设=ywc
衮=ywce
兖=ywcq
讼=ywcy
颃=ywdm
诊=ywe
诠=ywgg
谕=ywgj
褒=ywke
讥=ywn
交=ywr
郊=ywrb
䴔=ywrg
效=ywrt
讽=ywry
夜=ywt
於=ywuy
卒=yww
谶=ywwg
论=ywx
讹=ywxn
认=ywy
谁=ywyg
谂=ywyn
谯=ywyo
率=yx
紊=yxiu
诣=yxj
畜=yxl
雍=yxt
饔=yxte
壅=yxtf
玄=yxu
谐=yxx
方=yy
堃=yyff
文=yyg
谅=yyk
谆=yykb
该=yyn
谝=yyna
议=yyr
访=yyt
谤=yyu
谪=yyud
谛=yyuh
谇=yywf
言=yyy
